지역,월,일시,시간,승차,하차,전체
경기도 고양시 덕양구 주교동,1,평일,05시~06시,83 ,22 ,105 
경기도 고양시 덕양구 주교동,1,평일,06시~07시,269 ,76 ,345 
경기도 고양시 덕양구 주교동,1,평일,07시~08시,592 ,137 ,729 
경기도 고양시 덕양구 주교동,1,평일,08시~09시,603 ,290 ,893 
경기도 고양시 덕양구 주교동,1,평일,09시~10시,403 ,164 ,567 
경기도 고양시 덕양구 주교동,1,평일,10시~11시,268 ,172 ,440 
경기도 고양시 덕양구 주교동,1,평일,11시~12시,308 ,157 ,465 
경기도 고양시 덕양구 주교동,1,평일,12시~13시,249 ,181 ,430 
경기도 고양시 덕양구 주교동,1,평일,13시~14시,278 ,221 ,499 
경기도 고양시 덕양구 주교동,1,평일,14시~15시,256 ,204 ,460 
경기도 고양시 덕양구 주교동,1,평일,15시~16시,243 ,300 ,543 
경기도 고양시 덕양구 주교동,1,평일,16시~17시,226 ,307 ,533 
경기도 고양시 덕양구 주교동,1,평일,17시~18시,234 ,369 ,603 
경기도 고양시 덕양구 주교동,1,평일,18시~19시,323 ,406 ,729 
경기도 고양시 덕양구 주교동,1,평일,19시~20시,124 ,411 ,535 
경기도 고양시 덕양구 주교동,1,평일,20시~21시,90 ,257 ,347 
경기도 고양시 덕양구 주교동,1,평일,21시~22시,94 ,209 ,303 
경기도 고양시 덕양구 주교동,1,평일,22시~23시,37 ,197 ,234 
경기도 고양시 덕양구 주교동,1,평일,23시~24시,31 ,116 ,147 
경기도 고양시 덕양구 주교동,1,평일,00시~01시,2 ,7 ,9 
경기도 고양시 덕양구 주교동,1,평일,주간,3983 ,2908 ,6891 
경기도 고양시 덕양구 주교동,1,평일,전일,4713 ,4203 ,8916 
경기도 고양시 덕양구 주교동,1,주말,05시~06시,71 ,18 ,89 
경기도 고양시 덕양구 주교동,1,주말,06시~07시,125 ,65 ,190 
경기도 고양시 덕양구 주교동,1,주말,07시~08시,206 ,72 ,278 
경기도 고양시 덕양구 주교동,1,주말,08시~09시,299 ,117 ,416 
경기도 고양시 덕양구 주교동,1,주말,09시~10시,381 ,116 ,497 
경기도 고양시 덕양구 주교동,1,주말,10시~11시,305 ,109 ,414 
경기도 고양시 덕양구 주교동,1,주말,11시~12시,312 ,152 ,464 
경기도 고양시 덕양구 주교동,1,주말,12시~13시,292 ,162 ,454 
경기도 고양시 덕양구 주교동,1,주말,13시~14시,265 ,185 ,450 
경기도 고양시 덕양구 주교동,1,주말,14시~15시,246 ,198 ,444 
경기도 고양시 덕양구 주교동,1,주말,15시~16시,187 ,219 ,406 
경기도 고양시 덕양구 주교동,1,주말,16시~17시,204 ,232 ,436 
경기도 고양시 덕양구 주교동,1,주말,17시~18시,206 ,275 ,481 
경기도 고양시 덕양구 주교동,1,주말,18시~19시,186 ,295 ,481 
경기도 고양시 덕양구 주교동,1,주말,19시~20시,130 ,253 ,383 
경기도 고양시 덕양구 주교동,1,주말,20시~21시,62 ,235 ,297 
경기도 고양시 덕양구 주교동,1,주말,21시~22시,105 ,198 ,303 
경기도 고양시 덕양구 주교동,1,주말,22시~23시,55 ,191 ,246 
경기도 고양시 덕양구 주교동,1,주말,23시~24시,12 ,95 ,107 
경기도 고양시 덕양구 주교동,1,주말,00시~01시,6 ,4 ,10 
경기도 고양시 덕양구 주교동,1,주말,주간,3089 ,2132 ,5221 
경기도 고양시 덕양구 주교동,1,주말,전일,3655 ,3191 ,6846 
경기도 고양시 덕양구 원신동,1,평일,01시~02시,1 ,9 ,10 
경기도 고양시 덕양구 원신동,1,평일,04시~05시,15 ,4 ,19 
경기도 고양시 덕양구 원신동,1,평일,05시~06시,85 ,15 ,100 
경기도 고양시 덕양구 원신동,1,평일,06시~07시,286 ,87 ,373 
경기도 고양시 덕양구 원신동,1,평일,07시~08시,760 ,163 ,923 
경기도 고양시 덕양구 원신동,1,평일,08시~09시,734 ,293 ,1027 
경기도 고양시 덕양구 원신동,1,평일,09시~10시,395 ,261 ,656 
경기도 고양시 덕양구 원신동,1,평일,10시~11시,284 ,171 ,455 
경기도 고양시 덕양구 원신동,1,평일,11시~12시,240 ,161 ,401 
경기도 고양시 덕양구 원신동,1,평일,12시~13시,266 ,193 ,459 
경기도 고양시 덕양구 원신동,1,평일,13시~14시,250 ,217 ,467 
경기도 고양시 덕양구 원신동,1,평일,14시~15시,216 ,222 ,438 
경기도 고양시 덕양구 원신동,1,평일,15시~16시,240 ,281 ,521 
경기도 고양시 덕양구 원신동,1,평일,16시~17시,293 ,342 ,635 
경기도 고양시 덕양구 원신동,1,평일,17시~18시,286 ,362 ,648 
경기도 고양시 덕양구 원신동,1,평일,18시~19시,336 ,603 ,939 
경기도 고양시 덕양구 원신동,1,평일,19시~20시,257 ,647 ,904 
경기도 고양시 덕양구 원신동,1,평일,20시~21시,198 ,425 ,623 
경기도 고양시 덕양구 원신동,1,평일,21시~22시,184 ,329 ,513 
경기도 고양시 덕양구 원신동,1,평일,22시~23시,160 ,337 ,497 
경기도 고양시 덕양구 원신동,1,평일,23시~24시,65 ,214 ,279 
경기도 고양시 덕양구 원신동,1,평일,00시~01시,21 ,56 ,77 
경기도 고양시 덕양구 원신동,1,평일,주간,4300 ,3269 ,7569 
경기도 고양시 덕양구 원신동,1,평일,전일,5572 ,5392 ,10964 
경기도 고양시 덕양구 원신동,1,주말,01시~02시,5 ,9 ,14 
경기도 고양시 덕양구 원신동,1,주말,04시~05시,12 ,3 ,15 
경기도 고양시 덕양구 원신동,1,주말,05시~06시,48 ,6 ,54 
경기도 고양시 덕양구 원신동,1,주말,06시~07시,108 ,57 ,165 
경기도 고양시 덕양구 원신동,1,주말,07시~08시,198 ,100 ,298 
경기도 고양시 덕양구 원신동,1,주말,08시~09시,315 ,217 ,532 
경기도 고양시 덕양구 원신동,1,주말,09시~10시,308 ,195 ,503 
경기도 고양시 덕양구 원신동,1,주말,10시~11시,278 ,172 ,450 
경기도 고양시 덕양구 원신동,1,주말,11시~12시,312 ,171 ,483 
경기도 고양시 덕양구 원신동,1,주말,12시~13시,393 ,201 ,594 
경기도 고양시 덕양구 원신동,1,주말,13시~14시,297 ,225 ,522 
경기도 고양시 덕양구 원신동,1,주말,14시~15시,309 ,232 ,541 
경기도 고양시 덕양구 원신동,1,주말,15시~16시,288 ,236 ,524 
경기도 고양시 덕양구 원신동,1,주말,16시~17시,277 ,281 ,558 
경기도 고양시 덕양구 원신동,1,주말,17시~18시,285 ,356 ,641 
경기도 고양시 덕양구 원신동,1,주말,18시~19시,269 ,360 ,629 
경기도 고양시 덕양구 원신동,1,주말,19시~20시,155 ,329 ,484 
경기도 고양시 덕양구 원신동,1,주말,20시~21시,163 ,234 ,397 
경기도 고양시 덕양구 원신동,1,주말,21시~22시,156 ,246 ,402 
경기도 고양시 덕양구 원신동,1,주말,22시~23시,143 ,293 ,436 
경기도 고양시 덕양구 원신동,1,주말,23시~24시,83 ,165 ,248 
경기도 고양시 덕양구 원신동,1,주말,00시~01시,12 ,54 ,66 
경기도 고양시 덕양구 원신동,1,주말,주간,3529 ,2746 ,6275 
경기도 고양시 덕양구 원신동,1,주말,전일,4414 ,4142 ,8556 
경기도 고양시 덕양구 흥도동,1,평일,01시~02시,-,4 ,4 
경기도 고양시 덕양구 흥도동,1,평일,05시~06시,181 ,107 ,288 
경기도 고양시 덕양구 흥도동,1,평일,06시~07시,558 ,338 ,896 
경기도 고양시 덕양구 흥도동,1,평일,07시~08시,1405 ,898 ,2303 
경기도 고양시 덕양구 흥도동,1,평일,08시~09시,1349 ,1136 ,2485 
경기도 고양시 덕양구 흥도동,1,평일,09시~10시,650 ,548 ,1198 
경기도 고양시 덕양구 흥도동,1,평일,10시~11시,566 ,451 ,1017 
경기도 고양시 덕양구 흥도동,1,평일,11시~12시,484 ,429 ,913 
경기도 고양시 덕양구 흥도동,1,평일,12시~13시,498 ,457 ,955 
경기도 고양시 덕양구 흥도동,1,평일,13시~14시,564 ,505 ,1069 
경기도 고양시 덕양구 흥도동,1,평일,14시~15시,483 ,535 ,1018 
경기도 고양시 덕양구 흥도동,1,평일,15시~16시,576 ,627 ,1203 
경기도 고양시 덕양구 흥도동,1,평일,16시~17시,559 ,616 ,1175 
경기도 고양시 덕양구 흥도동,1,평일,17시~18시,714 ,785 ,1499 
경기도 고양시 덕양구 흥도동,1,평일,18시~19시,737 ,923 ,1660 
경기도 고양시 덕양구 흥도동,1,평일,19시~20시,766 ,1200 ,1966 
경기도 고양시 덕양구 흥도동,1,평일,20시~21시,552 ,798 ,1350 
경기도 고양시 덕양구 흥도동,1,평일,21시~22시,558 ,725 ,1283 
경기도 고양시 덕양구 흥도동,1,평일,22시~23시,433 ,653 ,1086 
경기도 고양시 덕양구 흥도동,1,평일,23시~24시,196 ,382 ,578 
경기도 고양시 덕양구 흥도동,1,평일,00시~01시,68 ,108 ,176 
경기도 고양시 덕양구 흥도동,1,평일,주간,8585 ,7910 ,16495 
경기도 고양시 덕양구 흥도동,1,평일,전일,11897 ,12225 ,24122 
경기도 고양시 덕양구 흥도동,1,주말,01시~02시,-,4 ,4 
경기도 고양시 덕양구 흥도동,1,주말,05시~06시,97 ,65 ,162 
경기도 고양시 덕양구 흥도동,1,주말,06시~07시,234 ,189 ,423 
경기도 고양시 덕양구 흥도동,1,주말,07시~08시,293 ,251 ,544 
경기도 고양시 덕양구 흥도동,1,주말,08시~09시,502 ,409 ,911 
경기도 고양시 덕양구 흥도동,1,주말,09시~10시,553 ,418 ,971 
경기도 고양시 덕양구 흥도동,1,주말,10시~11시,498 ,407 ,905 
경기도 고양시 덕양구 흥도동,1,주말,11시~12시,545 ,426 ,971 
경기도 고양시 덕양구 흥도동,1,주말,12시~13시,652 ,500 ,1152 
경기도 고양시 덕양구 흥도동,1,주말,13시~14시,584 ,546 ,1130 
경기도 고양시 덕양구 흥도동,1,주말,14시~15시,500 ,520 ,1020 
경기도 고양시 덕양구 흥도동,1,주말,15시~16시,523 ,533 ,1056 
경기도 고양시 덕양구 흥도동,1,주말,16시~17시,608 ,644 ,1252 
경기도 고양시 덕양구 흥도동,1,주말,17시~18시,638 ,664 ,1302 
경기도 고양시 덕양구 흥도동,1,주말,18시~19시,548 ,636 ,1184 
경기도 고양시 덕양구 흥도동,1,주말,19시~20시,461 ,591 ,1052 
경기도 고양시 덕양구 흥도동,1,주말,20시~21시,348 ,429 ,777 
경기도 고양시 덕양구 흥도동,1,주말,21시~22시,373 ,445 ,818 
경기도 고양시 덕양구 흥도동,1,주말,22시~23시,390 ,528 ,918 
경기도 고양시 덕양구 흥도동,1,주말,23시~24시,180 ,317 ,497 
경기도 고양시 덕양구 흥도동,1,주말,00시~01시,26 ,123 ,149 
경기도 고양시 덕양구 흥도동,1,주말,주간,6444 ,5954 ,12398 
경기도 고양시 덕양구 흥도동,1,주말,전일,8553 ,8645 ,17198 
경기도 고양시 덕양구 성사1동,1,평일,05시~06시,39 ,55 ,94 
경기도 고양시 덕양구 성사1동,1,평일,06시~07시,283 ,247 ,530 
경기도 고양시 덕양구 성사1동,1,평일,07시~08시,584 ,611 ,1195 
경기도 고양시 덕양구 성사1동,1,평일,08시~09시,626 ,838 ,1464 
경기도 고양시 덕양구 성사1동,1,평일,09시~10시,506 ,568 ,1074 
경기도 고양시 덕양구 성사1동,1,평일,10시~11시,377 ,465 ,842 
경기도 고양시 덕양구 성사1동,1,평일,11시~12시,474 ,445 ,919 
경기도 고양시 덕양구 성사1동,1,평일,12시~13시,466 ,480 ,946 
경기도 고양시 덕양구 성사1동,1,평일,13시~14시,534 ,500 ,1034 
경기도 고양시 덕양구 성사1동,1,평일,14시~15시,514 ,531 ,1045 
경기도 고양시 덕양구 성사1동,1,평일,15시~16시,620 ,629 ,1249 
경기도 고양시 덕양구 성사1동,1,평일,16시~17시,599 ,577 ,1176 
경기도 고양시 덕양구 성사1동,1,평일,17시~18시,616 ,590 ,1206 
경기도 고양시 덕양구 성사1동,1,평일,18시~19시,799 ,766 ,1565 
경기도 고양시 덕양구 성사1동,1,평일,19시~20시,588 ,718 ,1306 
경기도 고양시 덕양구 성사1동,1,평일,20시~21시,484 ,446 ,930 
경기도 고양시 덕양구 성사1동,1,평일,21시~22시,382 ,416 ,798 
경기도 고양시 덕양구 성사1동,1,평일,22시~23시,306 ,306 ,612 
경기도 고양시 덕양구 성사1동,1,평일,23시~24시,170 ,186 ,356 
경기도 고양시 덕양구 성사1동,1,평일,00시~01시,23 ,33 ,56 
경기도 고양시 덕양구 성사1동,1,평일,주간,6715 ,7000 ,13715 
경기도 고양시 덕양구 성사1동,1,평일,전일,8990 ,9407 ,18397 
경기도 고양시 덕양구 성사1동,1,주말,05시~06시,27 ,43 ,70 
경기도 고양시 덕양구 성사1동,1,주말,06시~07시,133 ,110 ,243 
경기도 고양시 덕양구 성사1동,1,주말,07시~08시,200 ,184 ,384 
경기도 고양시 덕양구 성사1동,1,주말,08시~09시,301 ,360 ,661 
경기도 고양시 덕양구 성사1동,1,주말,09시~10시,353 ,448 ,801 
경기도 고양시 덕양구 성사1동,1,주말,10시~11시,349 ,433 ,782 
경기도 고양시 덕양구 성사1동,1,주말,11시~12시,437 ,489 ,926 
경기도 고양시 덕양구 성사1동,1,주말,12시~13시,471 ,493 ,964 
경기도 고양시 덕양구 성사1동,1,주말,13시~14시,543 ,486 ,1029 
경기도 고양시 덕양구 성사1동,1,주말,14시~15시,480 ,454 ,934 
경기도 고양시 덕양구 성사1동,1,주말,15시~16시,536 ,446 ,982 
경기도 고양시 덕양구 성사1동,1,주말,16시~17시,487 ,504 ,991 
경기도 고양시 덕양구 성사1동,1,주말,17시~18시,537 ,545 ,1082 
경기도 고양시 덕양구 성사1동,1,주말,18시~19시,471 ,539 ,1010 
경기도 고양시 덕양구 성사1동,1,주말,19시~20시,454 ,467 ,921 
경기도 고양시 덕양구 성사1동,1,주말,20시~21시,376 ,336 ,712 
경기도 고양시 덕양구 성사1동,1,주말,21시~22시,330 ,354 ,684 
경기도 고양시 덕양구 성사1동,1,주말,22시~23시,231 ,274 ,505 
경기도 고양시 덕양구 성사1동,1,주말,23시~24시,145 ,158 ,303 
경기도 고양시 덕양구 성사1동,1,주말,00시~01시,33 ,55 ,88 
경기도 고양시 덕양구 성사1동,1,주말,주간,5165 ,5381 ,10546 
경기도 고양시 덕양구 성사1동,1,주말,전일,6894 ,7178 ,14072 
경기도 고양시 덕양구 성사2동,1,평일,04시~05시,-,7 ,7 
경기도 고양시 덕양구 성사2동,1,평일,05시~06시,11 ,17 ,28 
경기도 고양시 덕양구 성사2동,1,평일,06시~07시,67 ,44 ,111 
경기도 고양시 덕양구 성사2동,1,평일,07시~08시,228 ,123 ,351 
경기도 고양시 덕양구 성사2동,1,평일,08시~09시,214 ,144 ,358 
경기도 고양시 덕양구 성사2동,1,평일,09시~10시,84 ,72 ,156 
경기도 고양시 덕양구 성사2동,1,평일,10시~11시,81 ,75 ,156 
경기도 고양시 덕양구 성사2동,1,평일,11시~12시,72 ,56 ,128 
경기도 고양시 덕양구 성사2동,1,평일,12시~13시,68 ,87 ,155 
경기도 고양시 덕양구 성사2동,1,평일,13시~14시,60 ,65 ,125 
경기도 고양시 덕양구 성사2동,1,평일,14시~15시,84 ,108 ,192 
경기도 고양시 덕양구 성사2동,1,평일,15시~16시,71 ,110 ,181 
경기도 고양시 덕양구 성사2동,1,평일,16시~17시,59 ,129 ,188 
경기도 고양시 덕양구 성사2동,1,평일,17시~18시,61 ,106 ,167 
경기도 고양시 덕양구 성사2동,1,평일,18시~19시,123 ,202 ,325 
경기도 고양시 덕양구 성사2동,1,평일,19시~20시,68 ,164 ,232 
경기도 고양시 덕양구 성사2동,1,평일,20시~21시,33 ,113 ,146 
경기도 고양시 덕양구 성사2동,1,평일,21시~22시,46 ,110 ,156 
경기도 고양시 덕양구 성사2동,1,평일,22시~23시,33 ,109 ,142 
경기도 고양시 덕양구 성사2동,1,평일,23시~24시,19 ,78 ,97 
경기도 고양시 덕양구 성사2동,1,평일,00시~01시,17 ,28 ,45 
경기도 고양시 덕양구 성사2동,1,평일,주간,1205 ,1277 ,2482 
경기도 고양시 덕양구 성사2동,1,평일,전일,1499 ,1947 ,3446 
경기도 고양시 덕양구 성사2동,1,주말,04시~05시,-,1 ,1 
경기도 고양시 덕양구 성사2동,1,주말,05시~06시,14 ,18 ,32 
경기도 고양시 덕양구 성사2동,1,주말,06시~07시,24 ,21 ,45 
경기도 고양시 덕양구 성사2동,1,주말,07시~08시,53 ,39 ,92 
경기도 고양시 덕양구 성사2동,1,주말,08시~09시,66 ,59 ,125 
경기도 고양시 덕양구 성사2동,1,주말,09시~10시,76 ,48 ,124 
경기도 고양시 덕양구 성사2동,1,주말,10시~11시,66 ,58 ,124 
경기도 고양시 덕양구 성사2동,1,주말,11시~12시,72 ,58 ,130 
경기도 고양시 덕양구 성사2동,1,주말,12시~13시,64 ,69 ,133 
경기도 고양시 덕양구 성사2동,1,주말,13시~14시,55 ,92 ,147 
경기도 고양시 덕양구 성사2동,1,주말,14시~15시,56 ,90 ,146 
경기도 고양시 덕양구 성사2동,1,주말,15시~16시,64 ,87 ,151 
경기도 고양시 덕양구 성사2동,1,주말,16시~17시,71 ,92 ,163 
경기도 고양시 덕양구 성사2동,1,주말,17시~18시,60 ,96 ,156 
경기도 고양시 덕양구 성사2동,1,주말,18시~19시,52 ,112 ,164 
경기도 고양시 덕양구 성사2동,1,주말,19시~20시,43 ,95 ,138 
경기도 고양시 덕양구 성사2동,1,주말,20시~21시,21 ,72 ,93 
경기도 고양시 덕양구 성사2동,1,주말,21시~22시,49 ,91 ,140 
경기도 고양시 덕양구 성사2동,1,주말,22시~23시,30 ,94 ,124 
경기도 고양시 덕양구 성사2동,1,주말,23시~24시,18 ,72 ,90 
경기도 고양시 덕양구 성사2동,1,주말,00시~01시,15 ,33 ,48 
경기도 고양시 덕양구 성사2동,1,주말,주간,755 ,900 ,1655 
경기도 고양시 덕양구 성사2동,1,주말,전일,969 ,1397 ,2366 
경기도 고양시 덕양구 효자동,1,평일,05시~06시,8 ,7 ,15 
경기도 고양시 덕양구 효자동,1,평일,06시~07시,30 ,57 ,87 
경기도 고양시 덕양구 효자동,1,평일,07시~08시,52 ,143 ,195 
경기도 고양시 덕양구 효자동,1,평일,08시~09시,68 ,184 ,252 
경기도 고양시 덕양구 효자동,1,평일,09시~10시,31 ,80 ,111 
경기도 고양시 덕양구 효자동,1,평일,10시~11시,39 ,71 ,110 
경기도 고양시 덕양구 효자동,1,평일,11시~12시,37 ,57 ,94 
경기도 고양시 덕양구 효자동,1,평일,12시~13시,34 ,63 ,97 
경기도 고양시 덕양구 효자동,1,평일,13시~14시,47 ,54 ,101 
경기도 고양시 덕양구 효자동,1,평일,14시~15시,56 ,34 ,90 
경기도 고양시 덕양구 효자동,1,평일,15시~16시,78 ,37 ,115 
경기도 고양시 덕양구 효자동,1,평일,16시~17시,108 ,36 ,144 
경기도 고양시 덕양구 효자동,1,평일,17시~18시,108 ,46 ,154 
경기도 고양시 덕양구 효자동,1,평일,18시~19시,156 ,47 ,203 
경기도 고양시 덕양구 효자동,1,평일,19시~20시,134 ,38 ,172 
경기도 고양시 덕양구 효자동,1,평일,20시~21시,112 ,16 ,128 
경기도 고양시 덕양구 효자동,1,평일,21시~22시,75 ,16 ,91 
경기도 고양시 덕양구 효자동,1,평일,22시~23시,57 ,11 ,68 
경기도 고양시 덕양구 효자동,1,평일,23시~24시,16 ,3 ,19 
경기도 고양시 덕양구 효자동,1,평일,주간,814 ,852 ,1666 
경기도 고양시 덕양구 효자동,1,평일,전일,1246 ,1000 ,2246 
경기도 고양시 덕양구 효자동,1,주말,06시~07시,17 ,31 ,48 
경기도 고양시 덕양구 효자동,1,주말,07시~08시,28 ,51 ,79 
경기도 고양시 덕양구 효자동,1,주말,08시~09시,39 ,73 ,112 
경기도 고양시 덕양구 효자동,1,주말,09시~10시,35 ,77 ,112 
경기도 고양시 덕양구 효자동,1,주말,10시~11시,53 ,142 ,195 
경기도 고양시 덕양구 효자동,1,주말,11시~12시,62 ,95 ,157 
경기도 고양시 덕양구 효자동,1,주말,12시~13시,33 ,59 ,92 
경기도 고양시 덕양구 효자동,1,주말,13시~14시,54 ,50 ,104 
경기도 고양시 덕양구 효자동,1,주말,14시~15시,75 ,60 ,135 
경기도 고양시 덕양구 효자동,1,주말,15시~16시,96 ,63 ,159 
경기도 고양시 덕양구 효자동,1,주말,16시~17시,88 ,40 ,128 
경기도 고양시 덕양구 효자동,1,주말,17시~18시,104 ,78 ,182 
경기도 고양시 덕양구 효자동,1,주말,18시~19시,88 ,45 ,133 
경기도 고양시 덕양구 효자동,1,주말,19시~20시,63 ,28 ,91 
경기도 고양시 덕양구 효자동,1,주말,20시~21시,56 ,14 ,70 
경기도 고양시 덕양구 효자동,1,주말,21시~22시,65 ,15 ,80 
경기도 고양시 덕양구 효자동,1,주말,22시~23시,37 ,12 ,49 
경기도 고양시 덕양구 효자동,1,주말,23시~24시,18 ,2 ,20 
경기도 고양시 덕양구 효자동,1,주말,주간,755 ,833 ,1588 
경기도 고양시 덕양구 효자동,1,주말,전일,1011 ,935 ,1946 
경기도 고양시 덕양구 창릉동,1,평일,04시~05시,1 ,-,1 
경기도 고양시 덕양구 창릉동,1,평일,05시~06시,4 ,3 ,7 
경기도 고양시 덕양구 창릉동,1,평일,06시~07시,83 ,81 ,164 
경기도 고양시 덕양구 창릉동,1,평일,07시~08시,229 ,145 ,374 
경기도 고양시 덕양구 창릉동,1,평일,08시~09시,241 ,409 ,650 
경기도 고양시 덕양구 창릉동,1,평일,09시~10시,119 ,351 ,470 
경기도 고양시 덕양구 창릉동,1,평일,10시~11시,87 ,183 ,270 
경기도 고양시 덕양구 창릉동,1,평일,11시~12시,93 ,219 ,312 
경기도 고양시 덕양구 창릉동,1,평일,12시~13시,98 ,271 ,369 
경기도 고양시 덕양구 창릉동,1,평일,13시~14시,137 ,270 ,407 
경기도 고양시 덕양구 창릉동,1,평일,14시~15시,179 ,229 ,408 
경기도 고양시 덕양구 창릉동,1,평일,15시~16시,204 ,190 ,394 
경기도 고양시 덕양구 창릉동,1,평일,16시~17시,247 ,225 ,472 
경기도 고양시 덕양구 창릉동,1,평일,17시~18시,283 ,232 ,515 
경기도 고양시 덕양구 창릉동,1,평일,18시~19시,384 ,264 ,648 
경기도 고양시 덕양구 창릉동,1,평일,19시~20시,287 ,325 ,612 
경기도 고양시 덕양구 창릉동,1,평일,20시~21시,197 ,145 ,342 
경기도 고양시 덕양구 창릉동,1,평일,21시~22시,206 ,110 ,316 
경기도 고양시 덕양구 창릉동,1,평일,22시~23시,304 ,112 ,416 
경기도 고양시 덕양구 창릉동,1,평일,23시~24시,36 ,45 ,81 
경기도 고양시 덕양구 창릉동,1,평일,00시~01시,3 ,2 ,5 
경기도 고양시 덕양구 창릉동,1,평일,주간,2301 ,2988 ,5289 
경기도 고양시 덕양구 창릉동,1,평일,전일,3422 ,3811 ,7233 
경기도 고양시 덕양구 창릉동,1,주말,05시~06시,1 ,2 ,3 
경기도 고양시 덕양구 창릉동,1,주말,06시~07시,24 ,75 ,99 
경기도 고양시 덕양구 창릉동,1,주말,07시~08시,48 ,79 ,127 
경기도 고양시 덕양구 창릉동,1,주말,08시~09시,60 ,179 ,239 
경기도 고양시 덕양구 창릉동,1,주말,09시~10시,67 ,320 ,387 
경기도 고양시 덕양구 창릉동,1,주말,10시~11시,71 ,177 ,248 
경기도 고양시 덕양구 창릉동,1,주말,11시~12시,113 ,256 ,369 
경기도 고양시 덕양구 창릉동,1,주말,12시~13시,111 ,334 ,445 
경기도 고양시 덕양구 창릉동,1,주말,13시~14시,121 ,345 ,466 
경기도 고양시 덕양구 창릉동,1,주말,14시~15시,124 ,257 ,381 
경기도 고양시 덕양구 창릉동,1,주말,15시~16시,215 ,280 ,495 
경기도 고양시 덕양구 창릉동,1,주말,16시~17시,303 ,242 ,545 
경기도 고양시 덕양구 창릉동,1,주말,17시~18시,333 ,248 ,581 
경기도 고양시 덕양구 창릉동,1,주말,18시~19시,369 ,224 ,593 
경기도 고양시 덕양구 창릉동,1,주말,19시~20시,274 ,152 ,426 
경기도 고양시 덕양구 창릉동,1,주말,20시~21시,263 ,150 ,413 
경기도 고양시 덕양구 창릉동,1,주말,21시~22시,319 ,91 ,410 
경기도 고양시 덕양구 창릉동,1,주말,22시~23시,391 ,86 ,477 
경기도 고양시 덕양구 창릉동,1,주말,23시~24시,50 ,40 ,90 
경기도 고양시 덕양구 창릉동,1,주말,00시~01시,15 ,10 ,25 
경기도 고양시 덕양구 창릉동,1,주말,주간,1935 ,2941 ,4876 
경기도 고양시 덕양구 창릉동,1,주말,전일,3272 ,3547 ,6819 
경기도 고양시 덕양구 고양동,1,평일,01시~02시,-,4 ,4 
경기도 고양시 덕양구 고양동,1,평일,04시~05시,2 ,-,2 
경기도 고양시 덕양구 고양동,1,평일,05시~06시,172 ,29 ,201 
경기도 고양시 덕양구 고양동,1,평일,06시~07시,424 ,109 ,533 
경기도 고양시 덕양구 고양동,1,평일,07시~08시,973 ,330 ,1303 
경기도 고양시 덕양구 고양동,1,평일,08시~09시,870 ,552 ,1422 
경기도 고양시 덕양구 고양동,1,평일,09시~10시,733 ,449 ,1182 
경기도 고양시 덕양구 고양동,1,평일,10시~11시,614 ,414 ,1028 
경기도 고양시 덕양구 고양동,1,평일,11시~12시,561 ,431 ,992 
경기도 고양시 덕양구 고양동,1,평일,12시~13시,679 ,452 ,1131 
경기도 고양시 덕양구 고양동,1,평일,13시~14시,570 ,465 ,1035 
경기도 고양시 덕양구 고양동,1,평일,14시~15시,557 ,534 ,1091 
경기도 고양시 덕양구 고양동,1,평일,15시~16시,540 ,583 ,1123 
경기도 고양시 덕양구 고양동,1,평일,16시~17시,616 ,725 ,1341 
경기도 고양시 덕양구 고양동,1,평일,17시~18시,615 ,649 ,1264 
경기도 고양시 덕양구 고양동,1,평일,18시~19시,647 ,867 ,1514 
경기도 고양시 덕양구 고양동,1,평일,19시~20시,363 ,821 ,1184 
경기도 고양시 덕양구 고양동,1,평일,20시~21시,248 ,608 ,856 
경기도 고양시 덕양구 고양동,1,평일,21시~22시,273 ,539 ,812 
경기도 고양시 덕양구 고양동,1,평일,22시~23시,195 ,497 ,692 
경기도 고양시 덕양구 고양동,1,평일,23시~24시,81 ,302 ,383 
경기도 고양시 덕양구 고양동,1,평일,00시~01시,17 ,80 ,97 
경기도 고양시 덕양구 고양동,1,평일,주간,7975 ,6451 ,14426 
경기도 고양시 덕양구 고양동,1,평일,전일,9750 ,9440 ,19190 
경기도 고양시 덕양구 고양동,1,주말,01시~02시,1 ,6 ,7 
경기도 고양시 덕양구 고양동,1,주말,04시~05시,4 ,1 ,5 
경기도 고양시 덕양구 고양동,1,주말,05시~06시,105 ,22 ,127 
경기도 고양시 덕양구 고양동,1,주말,06시~07시,185 ,78 ,263 
경기도 고양시 덕양구 고양동,1,주말,07시~08시,359 ,208 ,567 
경기도 고양시 덕양구 고양동,1,주말,08시~09시,619 ,280 ,899 
경기도 고양시 덕양구 고양동,1,주말,09시~10시,630 ,381 ,1011 
경기도 고양시 덕양구 고양동,1,주말,10시~11시,617 ,328 ,945 
경기도 고양시 덕양구 고양동,1,주말,11시~12시,578 ,365 ,943 
경기도 고양시 덕양구 고양동,1,주말,12시~13시,645 ,437 ,1082 
경기도 고양시 덕양구 고양동,1,주말,13시~14시,547 ,412 ,959 
경기도 고양시 덕양구 고양동,1,주말,14시~15시,441 ,413 ,854 
경기도 고양시 덕양구 고양동,1,주말,15시~16시,500 ,484 ,984 
경기도 고양시 덕양구 고양동,1,주말,16시~17시,509 ,555 ,1064 
경기도 고양시 덕양구 고양동,1,주말,17시~18시,474 ,585 ,1059 
경기도 고양시 덕양구 고양동,1,주말,18시~19시,472 ,662 ,1134 
경기도 고양시 덕양구 고양동,1,주말,19시~20시,343 ,552 ,895 
경기도 고양시 덕양구 고양동,1,주말,20시~21시,236 ,395 ,631 
경기도 고양시 덕양구 고양동,1,주말,21시~22시,268 ,465 ,733 
경기도 고양시 덕양구 고양동,1,주말,22시~23시,206 ,468 ,674 
경기도 고양시 덕양구 고양동,1,주말,23시~24시,75 ,319 ,394 
경기도 고양시 덕양구 고양동,1,주말,00시~01시,9 ,80 ,89 
경기도 고양시 덕양구 고양동,1,주말,주간,6391 ,5110 ,11501 
경기도 고양시 덕양구 고양동,1,주말,전일,7823 ,7496 ,15319 
경기도 고양시 덕양구 관산동,1,평일,01시~02시,5 ,22 ,27 
경기도 고양시 덕양구 관산동,1,평일,02시~03시,-,3 ,3 
경기도 고양시 덕양구 관산동,1,평일,04시~05시,44 ,6 ,50 
경기도 고양시 덕양구 관산동,1,평일,05시~06시,226 ,43 ,269 
경기도 고양시 덕양구 관산동,1,평일,06시~07시,582 ,160 ,742 
경기도 고양시 덕양구 관산동,1,평일,07시~08시,1226 ,369 ,1595 
경기도 고양시 덕양구 관산동,1,평일,08시~09시,1148 ,574 ,1722 
경기도 고양시 덕양구 관산동,1,평일,09시~10시,774 ,364 ,1138 
경기도 고양시 덕양구 관산동,1,평일,10시~11시,677 ,342 ,1019 
경기도 고양시 덕양구 관산동,1,평일,11시~12시,565 ,368 ,933 
경기도 고양시 덕양구 관산동,1,평일,12시~13시,661 ,421 ,1082 
경기도 고양시 덕양구 관산동,1,평일,13시~14시,588 ,429 ,1017 
경기도 고양시 덕양구 관산동,1,평일,14시~15시,524 ,444 ,968 
경기도 고양시 덕양구 관산동,1,평일,15시~16시,499 ,599 ,1098 
경기도 고양시 덕양구 관산동,1,평일,16시~17시,517 ,713 ,1230 
경기도 고양시 덕양구 관산동,1,평일,17시~18시,649 ,769 ,1418 
경기도 고양시 덕양구 관산동,1,평일,18시~19시,668 ,970 ,1638 
경기도 고양시 덕양구 관산동,1,평일,19시~20시,358 ,937 ,1295 
경기도 고양시 덕양구 관산동,1,평일,20시~21시,245 ,739 ,984 
경기도 고양시 덕양구 관산동,1,평일,21시~22시,229 ,598 ,827 
경기도 고양시 덕양구 관산동,1,평일,22시~23시,201 ,628 ,829 
경기도 고양시 덕양구 관산동,1,평일,23시~24시,69 ,365 ,434 
경기도 고양시 덕양구 관산동,1,평일,00시~01시,28 ,130 ,158 
경기도 고양시 덕양구 관산동,1,평일,주간,8496 ,6362 ,14858 
경기도 고양시 덕양구 관산동,1,평일,전일,10483 ,9993 ,20476 
경기도 고양시 덕양구 관산동,1,주말,01시~02시,12 ,58 ,70 
경기도 고양시 덕양구 관산동,1,주말,04시~05시,56 ,4 ,60 
경기도 고양시 덕양구 관산동,1,주말,05시~06시,175 ,41 ,216 
경기도 고양시 덕양구 관산동,1,주말,06시~07시,300 ,128 ,428 
경기도 고양시 덕양구 관산동,1,주말,07시~08시,504 ,225 ,729 
경기도 고양시 덕양구 관산동,1,주말,08시~09시,697 ,279 ,976 
경기도 고양시 덕양구 관산동,1,주말,09시~10시,767 ,314 ,1081 
경기도 고양시 덕양구 관산동,1,주말,10시~11시,754 ,327 ,1081 
경기도 고양시 덕양구 관산동,1,주말,11시~12시,646 ,334 ,980 
경기도 고양시 덕양구 관산동,1,주말,12시~13시,748 ,458 ,1206 
경기도 고양시 덕양구 관산동,1,주말,13시~14시,618 ,424 ,1042 
경기도 고양시 덕양구 관산동,1,주말,14시~15시,549 ,462 ,1011 
경기도 고양시 덕양구 관산동,1,주말,15시~16시,599 ,563 ,1162 
경기도 고양시 덕양구 관산동,1,주말,16시~17시,524 ,630 ,1154 
경기도 고양시 덕양구 관산동,1,주말,17시~18시,546 ,594 ,1140 
경기도 고양시 덕양구 관산동,1,주말,18시~19시,473 ,733 ,1206 
경기도 고양시 덕양구 관산동,1,주말,19시~20시,324 ,651 ,975 
경기도 고양시 덕양구 관산동,1,주말,20시~21시,281 ,517 ,798 
경기도 고양시 덕양구 관산동,1,주말,21시~22시,239 ,548 ,787 
경기도 고양시 덕양구 관산동,1,주말,22시~23시,163 ,598 ,761 
경기도 고양시 덕양구 관산동,1,주말,23시~24시,96 ,359 ,455 
경기도 고양시 덕양구 관산동,1,주말,00시~01시,40 ,211 ,251 
경기도 고양시 덕양구 관산동,1,주말,주간,7425 ,5343 ,12768 
경기도 고양시 덕양구 관산동,1,주말,전일,9111 ,8458 ,17569 
경기도 고양시 덕양구 능곡동,1,평일,04시~05시,-,2 ,2 
경기도 고양시 덕양구 능곡동,1,평일,05시~06시,9 ,6 ,15 
경기도 고양시 덕양구 능곡동,1,평일,06시~07시,105 ,47 ,152 
경기도 고양시 덕양구 능곡동,1,평일,07시~08시,214 ,132 ,346 
경기도 고양시 덕양구 능곡동,1,평일,08시~09시,184 ,149 ,333 
경기도 고양시 덕양구 능곡동,1,평일,09시~10시,125 ,81 ,206 
경기도 고양시 덕양구 능곡동,1,평일,10시~11시,87 ,61 ,148 
경기도 고양시 덕양구 능곡동,1,평일,11시~12시,85 ,56 ,141 
경기도 고양시 덕양구 능곡동,1,평일,12시~13시,97 ,81 ,178 
경기도 고양시 덕양구 능곡동,1,평일,13시~14시,88 ,83 ,171 
경기도 고양시 덕양구 능곡동,1,평일,14시~15시,85 ,124 ,209 
경기도 고양시 덕양구 능곡동,1,평일,15시~16시,58 ,119 ,177 
경기도 고양시 덕양구 능곡동,1,평일,16시~17시,77 ,133 ,210 
경기도 고양시 덕양구 능곡동,1,평일,17시~18시,84 ,160 ,244 
경기도 고양시 덕양구 능곡동,1,평일,18시~19시,120 ,196 ,316 
경기도 고양시 덕양구 능곡동,1,평일,19시~20시,110 ,184 ,294 
경기도 고양시 덕양구 능곡동,1,평일,20시~21시,36 ,123 ,159 
경기도 고양시 덕양구 능곡동,1,평일,21시~22시,44 ,107 ,151 
경기도 고양시 덕양구 능곡동,1,평일,22시~23시,23 ,133 ,156 
경기도 고양시 덕양구 능곡동,1,평일,23시~24시,17 ,65 ,82 
경기도 고양시 덕양구 능곡동,1,평일,00시~01시,7 ,10 ,17 
경기도 고양시 덕양구 능곡동,1,평일,주간,1304 ,1375 ,2679 
경기도 고양시 덕양구 능곡동,1,평일,전일,1655 ,2052 ,3707 
경기도 고양시 덕양구 능곡동,1,주말,01시~02시,-,1 ,1 
경기도 고양시 덕양구 능곡동,1,주말,04시~05시,2 ,-,2 
경기도 고양시 덕양구 능곡동,1,주말,05시~06시,18 ,10 ,28 
경기도 고양시 덕양구 능곡동,1,주말,06시~07시,38 ,33 ,71 
경기도 고양시 덕양구 능곡동,1,주말,07시~08시,68 ,40 ,108 
경기도 고양시 덕양구 능곡동,1,주말,08시~09시,119 ,83 ,202 
경기도 고양시 덕양구 능곡동,1,주말,09시~10시,98 ,81 ,179 
경기도 고양시 덕양구 능곡동,1,주말,10시~11시,100 ,74 ,174 
경기도 고양시 덕양구 능곡동,1,주말,11시~12시,118 ,95 ,213 
경기도 고양시 덕양구 능곡동,1,주말,12시~13시,139 ,139 ,278 
경기도 고양시 덕양구 능곡동,1,주말,13시~14시,128 ,153 ,281 
경기도 고양시 덕양구 능곡동,1,주말,14시~15시,81 ,130 ,211 
경기도 고양시 덕양구 능곡동,1,주말,15시~16시,98 ,139 ,237 
경기도 고양시 덕양구 능곡동,1,주말,16시~17시,102 ,189 ,291 
경기도 고양시 덕양구 능곡동,1,주말,17시~18시,132 ,188 ,320 
경기도 고양시 덕양구 능곡동,1,주말,18시~19시,103 ,153 ,256 
경기도 고양시 덕양구 능곡동,1,주말,19시~20시,68 ,133 ,201 
경기도 고양시 덕양구 능곡동,1,주말,20시~21시,54 ,107 ,161 
경기도 고양시 덕양구 능곡동,1,주말,21시~22시,39 ,117 ,156 
경기도 고양시 덕양구 능곡동,1,주말,22시~23시,19 ,111 ,130 
경기도 고양시 덕양구 능곡동,1,주말,23시~24시,23 ,81 ,104 
경기도 고양시 덕양구 능곡동,1,주말,00시~01시,26 ,23 ,49 
경기도 고양시 덕양구 능곡동,1,주말,주간,1286 ,1464 ,2750 
경기도 고양시 덕양구 능곡동,1,주말,전일,1573 ,2080 ,3653 
경기도 고양시 덕양구 화정1동,1,평일,04시~05시,1 ,1 ,2 
경기도 고양시 덕양구 화정1동,1,평일,05시~06시,148 ,59 ,207 
경기도 고양시 덕양구 화정1동,1,평일,06시~07시,496 ,188 ,684 
경기도 고양시 덕양구 화정1동,1,평일,07시~08시,954 ,423 ,1377 
경기도 고양시 덕양구 화정1동,1,평일,08시~09시,1106 ,868 ,1974 
경기도 고양시 덕양구 화정1동,1,평일,09시~10시,639 ,700 ,1339 
경기도 고양시 덕양구 화정1동,1,평일,10시~11시,545 ,525 ,1070 
경기도 고양시 덕양구 화정1동,1,평일,11시~12시,722 ,607 ,1329 
경기도 고양시 덕양구 화정1동,1,평일,12시~13시,606 ,617 ,1223 
경기도 고양시 덕양구 화정1동,1,평일,13시~14시,602 ,741 ,1343 
경기도 고양시 덕양구 화정1동,1,평일,14시~15시,664 ,780 ,1444 
경기도 고양시 덕양구 화정1동,1,평일,15시~16시,716 ,784 ,1500 
경기도 고양시 덕양구 화정1동,1,평일,16시~17시,725 ,680 ,1405 
경기도 고양시 덕양구 화정1동,1,평일,17시~18시,843 ,896 ,1739 
경기도 고양시 덕양구 화정1동,1,평일,18시~19시,749 ,968 ,1717 
경기도 고양시 덕양구 화정1동,1,평일,19시~20시,573 ,938 ,1511 
경기도 고양시 덕양구 화정1동,1,평일,20시~21시,489 ,657 ,1146 
경기도 고양시 덕양구 화정1동,1,평일,21시~22시,423 ,625 ,1048 
경기도 고양시 덕양구 화정1동,1,평일,22시~23시,471 ,566 ,1037 
경기도 고양시 덕양구 화정1동,1,평일,23시~24시,219 ,400 ,619 
경기도 고양시 덕양구 화정1동,1,평일,00시~01시,37 ,90 ,127 
경기도 고양시 덕양구 화정1동,1,평일,주간,8871 ,8589 ,17460 
경기도 고양시 덕양구 화정1동,1,평일,전일,11728 ,12113 ,23841 
경기도 고양시 덕양구 화정1동,1,주말,04시~05시,1 ,-,1 
경기도 고양시 덕양구 화정1동,1,주말,05시~06시,103 ,80 ,183 
경기도 고양시 덕양구 화정1동,1,주말,06시~07시,182 ,121 ,303 
경기도 고양시 덕양구 화정1동,1,주말,07시~08시,258 ,197 ,455 
경기도 고양시 덕양구 화정1동,1,주말,08시~09시,478 ,360 ,838 
경기도 고양시 덕양구 화정1동,1,주말,09시~10시,533 ,512 ,1045 
경기도 고양시 덕양구 화정1동,1,주말,10시~11시,557 ,514 ,1071 
경기도 고양시 덕양구 화정1동,1,주말,11시~12시,600 ,535 ,1135 
경기도 고양시 덕양구 화정1동,1,주말,12시~13시,779 ,680 ,1459 
경기도 고양시 덕양구 화정1동,1,주말,13시~14시,633 ,660 ,1293 
경기도 고양시 덕양구 화정1동,1,주말,14시~15시,635 ,607 ,1242 
경기도 고양시 덕양구 화정1동,1,주말,15시~16시,717 ,571 ,1288 
경기도 고양시 덕양구 화정1동,1,주말,16시~17시,750 ,613 ,1363 
경기도 고양시 덕양구 화정1동,1,주말,17시~18시,748 ,575 ,1323 
경기도 고양시 덕양구 화정1동,1,주말,18시~19시,582 ,714 ,1296 
경기도 고양시 덕양구 화정1동,1,주말,19시~20시,486 ,567 ,1053 
경기도 고양시 덕양구 화정1동,1,주말,20시~21시,386 ,455 ,841 
경기도 고양시 덕양구 화정1동,1,주말,21시~22시,456 ,457 ,913 
경기도 고양시 덕양구 화정1동,1,주말,22시~23시,477 ,465 ,942 
경기도 고양시 덕양구 화정1동,1,주말,23시~24시,299 ,325 ,624 
경기도 고양시 덕양구 화정1동,1,주말,00시~01시,36 ,117 ,153 
경기도 고양시 덕양구 화정1동,1,주말,주간,7270 ,6538 ,13808 
경기도 고양시 덕양구 화정1동,1,주말,전일,9696 ,9125 ,18821 
경기도 고양시 덕양구 화정2동,1,평일,01시~02시,1 ,5 ,6 
경기도 고양시 덕양구 화정2동,1,평일,02시~03시,-,2 ,2 
경기도 고양시 덕양구 화정2동,1,평일,04시~05시,20 ,6 ,26 
경기도 고양시 덕양구 화정2동,1,평일,05시~06시,140 ,79 ,219 
경기도 고양시 덕양구 화정2동,1,평일,06시~07시,385 ,216 ,601 
경기도 고양시 덕양구 화정2동,1,평일,07시~08시,988 ,519 ,1507 
경기도 고양시 덕양구 화정2동,1,평일,08시~09시,928 ,738 ,1666 
경기도 고양시 덕양구 화정2동,1,평일,09시~10시,504 ,546 ,1050 
경기도 고양시 덕양구 화정2동,1,평일,10시~11시,358 ,480 ,838 
경기도 고양시 덕양구 화정2동,1,평일,11시~12시,370 ,500 ,870 
경기도 고양시 덕양구 화정2동,1,평일,12시~13시,374 ,497 ,871 
경기도 고양시 덕양구 화정2동,1,평일,13시~14시,460 ,596 ,1056 
경기도 고양시 덕양구 화정2동,1,평일,14시~15시,506 ,545 ,1051 
경기도 고양시 덕양구 화정2동,1,평일,15시~16시,578 ,617 ,1195 
경기도 고양시 덕양구 화정2동,1,평일,16시~17시,594 ,639 ,1233 
경기도 고양시 덕양구 화정2동,1,평일,17시~18시,607 ,745 ,1352 
경기도 고양시 덕양구 화정2동,1,평일,18시~19시,774 ,916 ,1690 
경기도 고양시 덕양구 화정2동,1,평일,19시~20시,528 ,941 ,1469 
경기도 고양시 덕양구 화정2동,1,평일,20시~21시,446 ,638 ,1084 
경기도 고양시 덕양구 화정2동,1,평일,21시~22시,413 ,480 ,893 
경기도 고양시 덕양구 화정2동,1,평일,22시~23시,520 ,456 ,976 
경기도 고양시 덕양구 화정2동,1,평일,23시~24시,245 ,330 ,575 
경기도 고양시 덕양구 화정2동,1,평일,00시~01시,64 ,116 ,180 
경기도 고양시 덕양구 화정2동,1,평일,주간,7041 ,7338 ,14379 
경기도 고양시 덕양구 화정2동,1,평일,전일,9803 ,10607 ,20410 
경기도 고양시 덕양구 화정2동,1,주말,01시~02시,4 ,10 ,14 
경기도 고양시 덕양구 화정2동,1,주말,02시~03시,1 ,3 ,4 
경기도 고양시 덕양구 화정2동,1,주말,04시~05시,9 ,3 ,12 
경기도 고양시 덕양구 화정2동,1,주말,05시~06시,79 ,80 ,159 
경기도 고양시 덕양구 화정2동,1,주말,06시~07시,157 ,122 ,279 
경기도 고양시 덕양구 화정2동,1,주말,07시~08시,222 ,187 ,409 
경기도 고양시 덕양구 화정2동,1,주말,08시~09시,364 ,399 ,763 
경기도 고양시 덕양구 화정2동,1,주말,09시~10시,362 ,516 ,878 
경기도 고양시 덕양구 화정2동,1,주말,10시~11시,379 ,471 ,850 
경기도 고양시 덕양구 화정2동,1,주말,11시~12시,480 ,604 ,1084 
경기도 고양시 덕양구 화정2동,1,주말,12시~13시,495 ,600 ,1095 
경기도 고양시 덕양구 화정2동,1,주말,13시~14시,563 ,716 ,1279 
경기도 고양시 덕양구 화정2동,1,주말,14시~15시,495 ,588 ,1083 
경기도 고양시 덕양구 화정2동,1,주말,15시~16시,607 ,606 ,1213 
경기도 고양시 덕양구 화정2동,1,주말,16시~17시,585 ,602 ,1187 
경기도 고양시 덕양구 화정2동,1,주말,17시~18시,586 ,726 ,1312 
경기도 고양시 덕양구 화정2동,1,주말,18시~19시,544 ,658 ,1202 
경기도 고양시 덕양구 화정2동,1,주말,19시~20시,417 ,573 ,990 
경기도 고양시 덕양구 화정2동,1,주말,20시~21시,371 ,474 ,845 
경기도 고양시 덕양구 화정2동,1,주말,21시~22시,408 ,449 ,857 
경기도 고양시 덕양구 화정2동,1,주말,22시~23시,476 ,478 ,954 
경기도 고양시 덕양구 화정2동,1,주말,23시~24시,228 ,346 ,574 
경기도 고양시 덕양구 화정2동,1,주말,00시~01시,73 ,173 ,246 
경기도 고양시 덕양구 화정2동,1,주말,주간,5682 ,6673 ,12355 
경기도 고양시 덕양구 화정2동,1,주말,전일,7905 ,9384 ,17289 
경기도 고양시 덕양구 행주동,1,평일,01시~02시,2 ,2 ,4 
경기도 고양시 덕양구 행주동,1,평일,04시~05시,9 ,-,9 
경기도 고양시 덕양구 행주동,1,평일,05시~06시,95 ,18 ,113 
경기도 고양시 덕양구 행주동,1,평일,06시~07시,263 ,62 ,325 
경기도 고양시 덕양구 행주동,1,평일,07시~08시,589 ,146 ,735 
경기도 고양시 덕양구 행주동,1,평일,08시~09시,455 ,197 ,652 
경기도 고양시 덕양구 행주동,1,평일,09시~10시,286 ,123 ,409 
경기도 고양시 덕양구 행주동,1,평일,10시~11시,227 ,107 ,334 
경기도 고양시 덕양구 행주동,1,평일,11시~12시,175 ,110 ,285 
경기도 고양시 덕양구 행주동,1,평일,12시~13시,204 ,125 ,329 
경기도 고양시 덕양구 행주동,1,평일,13시~14시,194 ,120 ,314 
경기도 고양시 덕양구 행주동,1,평일,14시~15시,193 ,148 ,341 
경기도 고양시 덕양구 행주동,1,평일,15시~16시,135 ,140 ,275 
경기도 고양시 덕양구 행주동,1,평일,16시~17시,165 ,194 ,359 
경기도 고양시 덕양구 행주동,1,평일,17시~18시,214 ,277 ,491 
경기도 고양시 덕양구 행주동,1,평일,18시~19시,222 ,332 ,554 
경기도 고양시 덕양구 행주동,1,평일,19시~20시,168 ,372 ,540 
경기도 고양시 덕양구 행주동,1,평일,20시~21시,100 ,277 ,377 
경기도 고양시 덕양구 행주동,1,평일,21시~22시,88 ,281 ,369 
경기도 고양시 덕양구 행주동,1,평일,22시~23시,78 ,289 ,367 
경기도 고양시 덕양구 행주동,1,평일,23시~24시,56 ,162 ,218 
경기도 고양시 덕양구 행주동,1,평일,00시~01시,10 ,41 ,51 
경기도 고양시 덕양구 행주동,1,평일,주간,3059 ,2019 ,5078 
경기도 고양시 덕양구 행주동,1,평일,전일,3928 ,3523 ,7451 
경기도 고양시 덕양구 행주동,1,주말,01시~02시,3 ,2 ,5 
경기도 고양시 덕양구 행주동,1,주말,04시~05시,6 ,-,6 
경기도 고양시 덕양구 행주동,1,주말,05시~06시,108 ,29 ,137 
경기도 고양시 덕양구 행주동,1,주말,06시~07시,128 ,80 ,208 
경기도 고양시 덕양구 행주동,1,주말,07시~08시,235 ,113 ,348 
경기도 고양시 덕양구 행주동,1,주말,08시~09시,355 ,193 ,548 
경기도 고양시 덕양구 행주동,1,주말,09시~10시,406 ,176 ,582 
경기도 고양시 덕양구 행주동,1,주말,10시~11시,334 ,165 ,499 
경기도 고양시 덕양구 행주동,1,주말,11시~12시,393 ,197 ,590 
경기도 고양시 덕양구 행주동,1,주말,12시~13시,399 ,245 ,644 
경기도 고양시 덕양구 행주동,1,주말,13시~14시,399 ,216 ,615 
경기도 고양시 덕양구 행주동,1,주말,14시~15시,301 ,259 ,560 
경기도 고양시 덕양구 행주동,1,주말,15시~16시,317 ,305 ,622 
경기도 고양시 덕양구 행주동,1,주말,16시~17시,353 ,307 ,660 
경기도 고양시 덕양구 행주동,1,주말,17시~18시,333 ,329 ,662 
경기도 고양시 덕양구 행주동,1,주말,18시~19시,298 ,304 ,602 
경기도 고양시 덕양구 행주동,1,주말,19시~20시,233 ,329 ,562 
경기도 고양시 덕양구 행주동,1,주말,20시~21시,180 ,241 ,421 
경기도 고양시 덕양구 행주동,1,주말,21시~22시,151 ,295 ,446 
경기도 고양시 덕양구 행주동,1,주말,22시~23시,134 ,326 ,460 
경기도 고양시 덕양구 행주동,1,주말,23시~24시,61 ,217 ,278 
경기도 고양시 덕양구 행주동,1,주말,00시~01시,9 ,68 ,77 
경기도 고양시 덕양구 행주동,1,주말,주간,4123 ,2809 ,6932 
경기도 고양시 덕양구 행주동,1,주말,전일,5136 ,4396 ,9532 
경기도 고양시 덕양구 행신1동,1,평일,01시~02시,2 ,8 ,10 
경기도 고양시 덕양구 행신1동,1,평일,04시~05시,24 ,2 ,26 
경기도 고양시 덕양구 행신1동,1,평일,05시~06시,177 ,24 ,201 
경기도 고양시 덕양구 행신1동,1,평일,06시~07시,477 ,43 ,520 
경기도 고양시 덕양구 행신1동,1,평일,07시~08시,978 ,74 ,1052 
경기도 고양시 덕양구 행신1동,1,평일,08시~09시,852 ,207 ,1059 
경기도 고양시 덕양구 행신1동,1,평일,09시~10시,447 ,164 ,611 
경기도 고양시 덕양구 행신1동,1,평일,10시~11시,352 ,112 ,464 
경기도 고양시 덕양구 행신1동,1,평일,11시~12시,286 ,139 ,425 
경기도 고양시 덕양구 행신1동,1,평일,12시~13시,327 ,125 ,452 
경기도 고양시 덕양구 행신1동,1,평일,13시~14시,313 ,203 ,516 
경기도 고양시 덕양구 행신1동,1,평일,14시~15시,229 ,167 ,396 
경기도 고양시 덕양구 행신1동,1,평일,15시~16시,200 ,189 ,389 
경기도 고양시 덕양구 행신1동,1,평일,16시~17시,216 ,251 ,467 
경기도 고양시 덕양구 행신1동,1,평일,17시~18시,285 ,293 ,578 
경기도 고양시 덕양구 행신1동,1,평일,18시~19시,258 ,434 ,692 
경기도 고양시 덕양구 행신1동,1,평일,19시~20시,136 ,399 ,535 
경기도 고양시 덕양구 행신1동,1,평일,20시~21시,105 ,255 ,360 
경기도 고양시 덕양구 행신1동,1,평일,21시~22시,91 ,275 ,366 
경기도 고양시 덕양구 행신1동,1,평일,22시~23시,100 ,249 ,349 
경기도 고양시 덕양구 행신1동,1,평일,23시~24시,27 ,144 ,171 
경기도 고양시 덕양구 행신1동,1,평일,00시~01시,8 ,41 ,49 
경기도 고양시 덕양구 행신1동,1,평일,주간,4743 ,2358 ,7101 
경기도 고양시 덕양구 행신1동,1,평일,전일,5890 ,3798 ,9688 
경기도 고양시 덕양구 행신1동,1,주말,01시~02시,2 ,7 ,9 
경기도 고양시 덕양구 행신1동,1,주말,04시~05시,15 ,1 ,16 
경기도 고양시 덕양구 행신1동,1,주말,05시~06시,112 ,23 ,135 
경기도 고양시 덕양구 행신1동,1,주말,06시~07시,135 ,47 ,182 
경기도 고양시 덕양구 행신1동,1,주말,07시~08시,222 ,45 ,267 
경기도 고양시 덕양구 행신1동,1,주말,08시~09시,333 ,107 ,440 
경기도 고양시 덕양구 행신1동,1,주말,09시~10시,416 ,112 ,528 
경기도 고양시 덕양구 행신1동,1,주말,10시~11시,347 ,97 ,444 
경기도 고양시 덕양구 행신1동,1,주말,11시~12시,426 ,127 ,553 
경기도 고양시 덕양구 행신1동,1,주말,12시~13시,431 ,148 ,579 
경기도 고양시 덕양구 행신1동,1,주말,13시~14시,375 ,133 ,508 
경기도 고양시 덕양구 행신1동,1,주말,14시~15시,323 ,139 ,462 
경기도 고양시 덕양구 행신1동,1,주말,15시~16시,302 ,179 ,481 
경기도 고양시 덕양구 행신1동,1,주말,16시~17시,315 ,206 ,521 
경기도 고양시 덕양구 행신1동,1,주말,17시~18시,322 ,250 ,572 
경기도 고양시 덕양구 행신1동,1,주말,18시~19시,231 ,264 ,495 
경기도 고양시 덕양구 행신1동,1,주말,19시~20시,127 ,212 ,339 
경기도 고양시 덕양구 행신1동,1,주말,20시~21시,109 ,188 ,297 
경기도 고양시 덕양구 행신1동,1,주말,21시~22시,117 ,228 ,345 
경기도 고양시 덕양구 행신1동,1,주말,22시~23시,98 ,194 ,292 
경기도 고양시 덕양구 행신1동,1,주말,23시~24시,33 ,113 ,146 
경기도 고양시 덕양구 행신1동,1,주말,00시~01시,6 ,38 ,44 
경기도 고양시 덕양구 행신1동,1,주말,주간,4043 ,1807 ,5850 
경기도 고양시 덕양구 행신1동,1,주말,전일,4797 ,2858 ,7655 
경기도 고양시 덕양구 행신2동,1,평일,01시~02시,1 ,3 ,4 
경기도 고양시 덕양구 행신2동,1,평일,04시~05시,22 ,1 ,23 
경기도 고양시 덕양구 행신2동,1,평일,05시~06시,75 ,35 ,110 
경기도 고양시 덕양구 행신2동,1,평일,06시~07시,187 ,245 ,432 
경기도 고양시 덕양구 행신2동,1,평일,07시~08시,473 ,820 ,1293 
경기도 고양시 덕양구 행신2동,1,평일,08시~09시,648 ,738 ,1386 
경기도 고양시 덕양구 행신2동,1,평일,09시~10시,349 ,357 ,706 
경기도 고양시 덕양구 행신2동,1,평일,10시~11시,284 ,245 ,529 
경기도 고양시 덕양구 행신2동,1,평일,11시~12시,257 ,259 ,516 
경기도 고양시 덕양구 행신2동,1,평일,12시~13시,283 ,228 ,511 
경기도 고양시 덕양구 행신2동,1,평일,13시~14시,356 ,299 ,655 
경기도 고양시 덕양구 행신2동,1,평일,14시~15시,284 ,254 ,538 
경기도 고양시 덕양구 행신2동,1,평일,15시~16시,276 ,313 ,589 
경기도 고양시 덕양구 행신2동,1,평일,16시~17시,340 ,330 ,670 
경기도 고양시 덕양구 행신2동,1,평일,17시~18시,415 ,390 ,805 
경기도 고양시 덕양구 행신2동,1,평일,18시~19시,699 ,548 ,1247 
경기도 고양시 덕양구 행신2동,1,평일,19시~20시,641 ,529 ,1170 
경기도 고양시 덕양구 행신2동,1,평일,20시~21시,394 ,322 ,716 
경기도 고양시 덕양구 행신2동,1,평일,21시~22시,340 ,325 ,665 
경기도 고양시 덕양구 행신2동,1,평일,22시~23시,311 ,345 ,656 
경기도 고양시 덕양구 행신2동,1,평일,23시~24시,147 ,190 ,337 
경기도 고양시 덕양구 행신2동,1,평일,00시~01시,6 ,38 ,44 
경기도 고양시 덕양구 행신2동,1,평일,주간,4664 ,4781 ,9445 
경기도 고양시 덕양구 행신2동,1,평일,전일,6788 ,6814 ,13602 
경기도 고양시 덕양구 행신2동,1,주말,01시~02시,-,9 ,9 
경기도 고양시 덕양구 행신2동,1,주말,04시~05시,17 ,2 ,19 
경기도 고양시 덕양구 행신2동,1,주말,05시~06시,50 ,30 ,80 
경기도 고양시 덕양구 행신2동,1,주말,06시~07시,83 ,120 ,203 
경기도 고양시 덕양구 행신2동,1,주말,07시~08시,140 ,167 ,307 
경기도 고양시 덕양구 행신2동,1,주말,08시~09시,239 ,200 ,439 
경기도 고양시 덕양구 행신2동,1,주말,09시~10시,261 ,284 ,545 
경기도 고양시 덕양구 행신2동,1,주말,10시~11시,236 ,259 ,495 
경기도 고양시 덕양구 행신2동,1,주말,11시~12시,312 ,313 ,625 
경기도 고양시 덕양구 행신2동,1,주말,12시~13시,322 ,366 ,688 
경기도 고양시 덕양구 행신2동,1,주말,13시~14시,311 ,342 ,653 
경기도 고양시 덕양구 행신2동,1,주말,14시~15시,321 ,364 ,685 
경기도 고양시 덕양구 행신2동,1,주말,15시~16시,326 ,336 ,662 
경기도 고양시 덕양구 행신2동,1,주말,16시~17시,342 ,405 ,747 
경기도 고양시 덕양구 행신2동,1,주말,17시~18시,388 ,439 ,827 
경기도 고양시 덕양구 행신2동,1,주말,18시~19시,312 ,410 ,722 
경기도 고양시 덕양구 행신2동,1,주말,19시~20시,281 ,283 ,564 
경기도 고양시 덕양구 행신2동,1,주말,20시~21시,271 ,268 ,539 
경기도 고양시 덕양구 행신2동,1,주말,21시~22시,248 ,265 ,513 
경기도 고양시 덕양구 행신2동,1,주말,22시~23시,249 ,291 ,540 
경기도 고양시 덕양구 행신2동,1,주말,23시~24시,161 ,194 ,355 
경기도 고양시 덕양구 행신2동,1,주말,00시~01시,8 ,39 ,47 
경기도 고양시 덕양구 행신2동,1,주말,주간,3510 ,3885 ,7395 
경기도 고양시 덕양구 행신2동,1,주말,전일,4878 ,5386 ,10264 
경기도 고양시 덕양구 화전동,1,평일,05시~06시,10 ,30 ,40 
경기도 고양시 덕양구 화전동,1,평일,06시~07시,34 ,44 ,78 
경기도 고양시 덕양구 화전동,1,평일,07시~08시,66 ,112 ,178 
경기도 고양시 덕양구 화전동,1,평일,08시~09시,98 ,187 ,285 
경기도 고양시 덕양구 화전동,1,평일,09시~10시,59 ,83 ,142 
경기도 고양시 덕양구 화전동,1,평일,10시~11시,43 ,42 ,85 
경기도 고양시 덕양구 화전동,1,평일,11시~12시,38 ,50 ,88 
경기도 고양시 덕양구 화전동,1,평일,12시~13시,44 ,52 ,96 
경기도 고양시 덕양구 화전동,1,평일,13시~14시,55 ,42 ,97 
경기도 고양시 덕양구 화전동,1,평일,14시~15시,49 ,46 ,95 
경기도 고양시 덕양구 화전동,1,평일,15시~16시,44 ,57 ,101 
경기도 고양시 덕양구 화전동,1,평일,16시~17시,74 ,62 ,136 
경기도 고양시 덕양구 화전동,1,평일,17시~18시,61 ,54 ,115 
경기도 고양시 덕양구 화전동,1,평일,18시~19시,99 ,108 ,207 
경기도 고양시 덕양구 화전동,1,평일,19시~20시,66 ,71 ,137 
경기도 고양시 덕양구 화전동,1,평일,20시~21시,34 ,65 ,99 
경기도 고양시 덕양구 화전동,1,평일,21시~22시,22 ,39 ,61 
경기도 고양시 덕양구 화전동,1,평일,22시~23시,35 ,41 ,76 
경기도 고양시 덕양구 화전동,1,평일,23시~24시,13 ,27 ,40 
경기도 고양시 덕양구 화전동,1,평일,00시~01시,3 ,-,3 
경기도 고양시 덕양구 화전동,1,평일,주간,730 ,895 ,1625 
경기도 고양시 덕양구 화전동,1,평일,전일,947 ,1212 ,2159 
경기도 고양시 덕양구 화전동,1,주말,05시~06시,7 ,11 ,18 
경기도 고양시 덕양구 화전동,1,주말,06시~07시,30 ,29 ,59 
경기도 고양시 덕양구 화전동,1,주말,07시~08시,24 ,41 ,65 
경기도 고양시 덕양구 화전동,1,주말,08시~09시,89 ,74 ,163 
경기도 고양시 덕양구 화전동,1,주말,09시~10시,39 ,47 ,86 
경기도 고양시 덕양구 화전동,1,주말,10시~11시,43 ,32 ,75 
경기도 고양시 덕양구 화전동,1,주말,11시~12시,41 ,50 ,91 
경기도 고양시 덕양구 화전동,1,주말,12시~13시,62 ,73 ,135 
경기도 고양시 덕양구 화전동,1,주말,13시~14시,71 ,48 ,119 
경기도 고양시 덕양구 화전동,1,주말,14시~15시,43 ,45 ,88 
경기도 고양시 덕양구 화전동,1,주말,15시~16시,52 ,40 ,92 
경기도 고양시 덕양구 화전동,1,주말,16시~17시,61 ,64 ,125 
경기도 고양시 덕양구 화전동,1,주말,17시~18시,89 ,80 ,169 
경기도 고양시 덕양구 화전동,1,주말,18시~19시,75 ,79 ,154 
경기도 고양시 덕양구 화전동,1,주말,19시~20시,49 ,68 ,117 
경기도 고양시 덕양구 화전동,1,주말,20시~21시,37 ,46 ,83 
경기도 고양시 덕양구 화전동,1,주말,21시~22시,27 ,36 ,63 
경기도 고양시 덕양구 화전동,1,주말,22시~23시,23 ,41 ,64 
경기도 고양시 덕양구 화전동,1,주말,23시~24시,14 ,37 ,51 
경기도 고양시 덕양구 화전동,1,주말,00시~01시,3 ,2 ,5 
경기도 고양시 덕양구 화전동,1,주말,주간,689 ,673 ,1362 
경기도 고양시 덕양구 화전동,1,주말,전일,879 ,943 ,1822 
경기도 고양시 덕양구 대덕동,1,평일,05시~06시,1 ,-,1 
경기도 고양시 덕양구 대덕동,1,평일,06시~07시,-,5 ,5 
경기도 고양시 덕양구 대덕동,1,평일,07시~08시,1 ,4 ,5 
경기도 고양시 덕양구 대덕동,1,평일,08시~09시,7 ,12 ,19 
경기도 고양시 덕양구 대덕동,1,평일,09시~10시,2 ,5 ,7 
경기도 고양시 덕양구 대덕동,1,평일,10시~11시,5 ,4 ,9 
경기도 고양시 덕양구 대덕동,1,평일,11시~12시,3 ,1 ,4 
경기도 고양시 덕양구 대덕동,1,평일,12시~13시,2 ,4 ,6 
경기도 고양시 덕양구 대덕동,1,평일,13시~14시,1 ,4 ,5 
경기도 고양시 덕양구 대덕동,1,평일,14시~15시,1 ,4 ,5 
경기도 고양시 덕양구 대덕동,1,평일,16시~17시,5 ,2 ,7 
경기도 고양시 덕양구 대덕동,1,평일,17시~18시,5 ,5 ,10 
경기도 고양시 덕양구 대덕동,1,평일,18시~19시,7 ,5 ,12 
경기도 고양시 덕양구 대덕동,1,평일,19시~20시,2 ,2 ,4 
경기도 고양시 덕양구 대덕동,1,평일,20시~21시,3 ,1 ,4 
경기도 고양시 덕양구 대덕동,1,평일,21시~22시,3 ,-,3 
경기도 고양시 덕양구 대덕동,1,평일,주간,39 ,50 ,89 
경기도 고양시 덕양구 대덕동,1,평일,전일,48 ,58 ,106 
경기도 고양시 덕양구 대덕동,1,주말,06시~07시,-,1 ,1 
경기도 고양시 덕양구 대덕동,1,주말,07시~08시,-,1 ,1 
경기도 고양시 덕양구 대덕동,1,주말,08시~09시,4 ,3 ,7 
경기도 고양시 덕양구 대덕동,1,주말,09시~10시,4 ,3 ,7 
경기도 고양시 덕양구 대덕동,1,주말,10시~11시,4 ,4 ,8 
경기도 고양시 덕양구 대덕동,1,주말,11시~12시,3 ,4 ,7 
경기도 고양시 덕양구 대덕동,1,주말,12시~13시,1 ,1 ,2 
경기도 고양시 덕양구 대덕동,1,주말,13시~14시,2 ,4 ,6 
경기도 고양시 덕양구 대덕동,1,주말,14시~15시,1 ,5 ,6 
경기도 고양시 덕양구 대덕동,1,주말,15시~16시,1 ,1 ,2 
경기도 고양시 덕양구 대덕동,1,주말,16시~17시,3 ,-,3 
경기도 고양시 덕양구 대덕동,1,주말,17시~18시,4 ,1 ,5 
경기도 고양시 덕양구 대덕동,1,주말,18시~19시,1 ,-,1 
경기도 고양시 덕양구 대덕동,1,주말,19시~20시,1 ,1 ,2 
경기도 고양시 덕양구 대덕동,1,주말,20시~21시,1 ,1 ,2 
경기도 고양시 덕양구 대덕동,1,주말,주간,28 ,27 ,55 
경기도 고양시 덕양구 대덕동,1,주말,전일,30 ,30 ,60 
경기도 고양시 덕양구 행신3동,1,평일,01시~02시,4 ,18 ,22 
경기도 고양시 덕양구 행신3동,1,평일,02시~03시,2 ,3 ,5 
경기도 고양시 덕양구 행신3동,1,평일,04시~05시,13 ,-,13 
경기도 고양시 덕양구 행신3동,1,평일,05시~06시,122 ,48 ,170 
경기도 고양시 덕양구 행신3동,1,평일,06시~07시,342 ,104 ,446 
경기도 고양시 덕양구 행신3동,1,평일,07시~08시,802 ,215 ,1017 
경기도 고양시 덕양구 행신3동,1,평일,08시~09시,1094 ,426 ,1520 
경기도 고양시 덕양구 행신3동,1,평일,09시~10시,728 ,304 ,1032 
경기도 고양시 덕양구 행신3동,1,평일,10시~11시,491 ,249 ,740 
경기도 고양시 덕양구 행신3동,1,평일,11시~12시,509 ,292 ,801 
경기도 고양시 덕양구 행신3동,1,평일,12시~13시,495 ,314 ,809 
경기도 고양시 덕양구 행신3동,1,평일,13시~14시,539 ,387 ,926 
경기도 고양시 덕양구 행신3동,1,평일,14시~15시,470 ,431 ,901 
경기도 고양시 덕양구 행신3동,1,평일,15시~16시,446 ,570 ,1016 
경기도 고양시 덕양구 행신3동,1,평일,16시~17시,472 ,628 ,1100 
경기도 고양시 덕양구 행신3동,1,평일,17시~18시,512 ,828 ,1340 
경기도 고양시 덕양구 행신3동,1,평일,18시~19시,566 ,1097 ,1663 
경기도 고양시 덕양구 행신3동,1,평일,19시~20시,429 ,1512 ,1941 
경기도 고양시 덕양구 행신3동,1,평일,20시~21시,267 ,965 ,1232 
경기도 고양시 덕양구 행신3동,1,평일,21시~22시,230 ,897 ,1127 
경기도 고양시 덕양구 행신3동,1,평일,22시~23시,172 ,876 ,1048 
경기도 고양시 덕양구 행신3동,1,평일,23시~24시,122 ,577 ,699 
경기도 고양시 덕양구 행신3동,1,평일,00시~01시,12 ,174 ,186 
경기도 고양시 덕양구 행신3동,1,평일,주간,7124 ,5741 ,12865 
경기도 고양시 덕양구 행신3동,1,평일,전일,8839 ,10915 ,19754 
경기도 고양시 덕양구 행신3동,1,주말,01시~02시,4 ,27 ,31 
경기도 고양시 덕양구 행신3동,1,주말,02시~03시,-,3 ,3 
경기도 고양시 덕양구 행신3동,1,주말,04시~05시,5 ,-,5 
경기도 고양시 덕양구 행신3동,1,주말,05시~06시,71 ,27 ,98 
경기도 고양시 덕양구 행신3동,1,주말,06시~07시,167 ,99 ,266 
경기도 고양시 덕양구 행신3동,1,주말,07시~08시,281 ,89 ,370 
경기도 고양시 덕양구 행신3동,1,주말,08시~09시,467 ,175 ,642 
경기도 고양시 덕양구 행신3동,1,주말,09시~10시,524 ,223 ,747 
경기도 고양시 덕양구 행신3동,1,주말,10시~11시,493 ,226 ,719 
경기도 고양시 덕양구 행신3동,1,주말,11시~12시,530 ,259 ,789 
경기도 고양시 덕양구 행신3동,1,주말,12시~13시,544 ,359 ,903 
경기도 고양시 덕양구 행신3동,1,주말,13시~14시,547 ,391 ,938 
경기도 고양시 덕양구 행신3동,1,주말,14시~15시,438 ,438 ,876 
경기도 고양시 덕양구 행신3동,1,주말,15시~16시,436 ,511 ,947 
경기도 고양시 덕양구 행신3동,1,주말,16시~17시,480 ,580 ,1060 
경기도 고양시 덕양구 행신3동,1,주말,17시~18시,424 ,637 ,1061 
경기도 고양시 덕양구 행신3동,1,주말,18시~19시,425 ,756 ,1181 
경기도 고양시 덕양구 행신3동,1,주말,19시~20시,299 ,665 ,964 
경기도 고양시 덕양구 행신3동,1,주말,20시~21시,278 ,539 ,817 
경기도 고양시 덕양구 행신3동,1,주말,21시~22시,171 ,602 ,773 
경기도 고양시 덕양구 행신3동,1,주말,22시~23시,177 ,671 ,848 
경기도 고양시 덕양구 행신3동,1,주말,23시~24시,94 ,578 ,672 
경기도 고양시 덕양구 행신3동,1,주말,00시~01시,20 ,157 ,177 
경기도 고양시 덕양구 행신3동,1,주말,주간,5589 ,4644 ,10233 
경기도 고양시 덕양구 행신3동,1,주말,전일,6875 ,8012 ,14887 
경기도 고양시 덕양구 삼송동,1,평일,01시~02시,3 ,3 ,6 
경기도 고양시 덕양구 삼송동,1,평일,04시~05시,1 ,12 ,13 
경기도 고양시 덕양구 삼송동,1,평일,05시~06시,34 ,105 ,139 
경기도 고양시 덕양구 삼송동,1,평일,06시~07시,338 ,671 ,1009 
경기도 고양시 덕양구 삼송동,1,평일,07시~08시,803 ,1976 ,2779 
경기도 고양시 덕양구 삼송동,1,평일,08시~09시,912 ,1995 ,2907 
경기도 고양시 덕양구 삼송동,1,평일,09시~10시,604 ,1049 ,1653 
경기도 고양시 덕양구 삼송동,1,평일,10시~11시,425 ,669 ,1094 
경기도 고양시 덕양구 삼송동,1,평일,11시~12시,489 ,596 ,1085 
경기도 고양시 덕양구 삼송동,1,평일,12시~13시,569 ,678 ,1247 
경기도 고양시 덕양구 삼송동,1,평일,13시~14시,563 ,622 ,1185 
경기도 고양시 덕양구 삼송동,1,평일,14시~15시,579 ,548 ,1127 
경기도 고양시 덕양구 삼송동,1,평일,15시~16시,692 ,596 ,1288 
경기도 고양시 덕양구 삼송동,1,평일,16시~17시,755 ,684 ,1439 
경기도 고양시 덕양구 삼송동,1,평일,17시~18시,899 ,698 ,1597 
경기도 고양시 덕양구 삼송동,1,평일,18시~19시,1338 ,912 ,2250 
경기도 고양시 덕양구 삼송동,1,평일,19시~20시,1613 ,770 ,2383 
경기도 고양시 덕양구 삼송동,1,평일,20시~21시,989 ,509 ,1498 
경기도 고양시 덕양구 삼송동,1,평일,21시~22시,770 ,442 ,1212 
경기도 고양시 덕양구 삼송동,1,평일,22시~23시,792 ,478 ,1270 
경기도 고양시 덕양구 삼송동,1,평일,23시~24시,367 ,175 ,542 
경기도 고양시 덕양구 삼송동,1,평일,00시~01시,52 ,43 ,95 
경기도 고양시 덕양구 삼송동,1,평일,주간,8628 ,11023 ,19651 
경기도 고양시 덕양구 삼송동,1,평일,전일,13587 ,14231 ,27818 
경기도 고양시 덕양구 삼송동,1,주말,01시~02시,9 ,6 ,15 
경기도 고양시 덕양구 삼송동,1,주말,04시~05시,1 ,14 ,15 
경기도 고양시 덕양구 삼송동,1,주말,05시~06시,35 ,64 ,99 
경기도 고양시 덕양구 삼송동,1,주말,06시~07시,182 ,233 ,415 
경기도 고양시 덕양구 삼송동,1,주말,07시~08시,242 ,440 ,682 
경기도 고양시 덕양구 삼송동,1,주말,08시~09시,431 ,717 ,1148 
경기도 고양시 덕양구 삼송동,1,주말,09시~10시,531 ,758 ,1289 
경기도 고양시 덕양구 삼송동,1,주말,10시~11시,426 ,671 ,1097 
경기도 고양시 덕양구 삼송동,1,주말,11시~12시,501 ,752 ,1253 
경기도 고양시 덕양구 삼송동,1,주말,12시~13시,554 ,787 ,1341 
경기도 고양시 덕양구 삼송동,1,주말,13시~14시,573 ,736 ,1309 
경기도 고양시 덕양구 삼송동,1,주말,14시~15시,580 ,563 ,1143 
경기도 고양시 덕양구 삼송동,1,주말,15시~16시,594 ,629 ,1223 
경기도 고양시 덕양구 삼송동,1,주말,16시~17시,658 ,603 ,1261 
경기도 고양시 덕양구 삼송동,1,주말,17시~18시,743 ,628 ,1371 
경기도 고양시 덕양구 삼송동,1,주말,18시~19시,752 ,583 ,1335 
경기도 고양시 덕양구 삼송동,1,주말,19시~20시,641 ,459 ,1100 
경기도 고양시 덕양구 삼송동,1,주말,20시~21시,549 ,386 ,935 
경기도 고양시 덕양구 삼송동,1,주말,21시~22시,526 ,404 ,930 
경기도 고양시 덕양구 삼송동,1,주말,22시~23시,542 ,442 ,984 
경기도 고양시 덕양구 삼송동,1,주말,23시~24시,355 ,177 ,532 
경기도 고양시 덕양구 삼송동,1,주말,00시~01시,36 ,59 ,95 
경기도 고양시 덕양구 삼송동,1,주말,주간,6585 ,7867 ,14452 
경기도 고양시 덕양구 삼송동,1,주말,전일,9461 ,10111 ,19572 
경기도 고양시 일산동구 식사동,1,평일,01시~02시,3 ,21 ,24 
경기도 고양시 일산동구 식사동,1,평일,04시~05시,21 ,-,21 
경기도 고양시 일산동구 식사동,1,평일,05시~06시,75 ,9 ,84 
경기도 고양시 일산동구 식사동,1,평일,06시~07시,260 ,129 ,389 
경기도 고양시 일산동구 식사동,1,평일,07시~08시,573 ,235 ,808 
경기도 고양시 일산동구 식사동,1,평일,08시~09시,540 ,549 ,1089 
경기도 고양시 일산동구 식사동,1,평일,09시~10시,444 ,345 ,789 
경기도 고양시 일산동구 식사동,1,평일,10시~11시,383 ,218 ,601 
경기도 고양시 일산동구 식사동,1,평일,11시~12시,337 ,211 ,548 
경기도 고양시 일산동구 식사동,1,평일,12시~13시,356 ,251 ,607 
경기도 고양시 일산동구 식사동,1,평일,13시~14시,363 ,324 ,687 
경기도 고양시 일산동구 식사동,1,평일,14시~15시,346 ,318 ,664 
경기도 고양시 일산동구 식사동,1,평일,15시~16시,379 ,289 ,668 
경기도 고양시 일산동구 식사동,1,평일,16시~17시,383 ,317 ,700 
경기도 고양시 일산동구 식사동,1,평일,17시~18시,485 ,375 ,860 
경기도 고양시 일산동구 식사동,1,평일,18시~19시,473 ,445 ,918 
경기도 고양시 일산동구 식사동,1,평일,19시~20시,246 ,523 ,769 
경기도 고양시 일산동구 식사동,1,평일,20시~21시,191 ,361 ,552 
경기도 고양시 일산동구 식사동,1,평일,21시~22시,192 ,363 ,555 
경기도 고양시 일산동구 식사동,1,평일,22시~23시,166 ,361 ,527 
경기도 고양시 일산동구 식사동,1,평일,23시~24시,126 ,279 ,405 
경기도 고양시 일산동구 식사동,1,평일,00시~01시,14 ,103 ,117 
경기도 고양시 일산동구 식사동,1,평일,주간,5062 ,3877 ,8939 
경기도 고양시 일산동구 식사동,1,평일,전일,6356 ,6026 ,12382 
경기도 고양시 일산동구 식사동,1,주말,01시~02시,-,15 ,15 
경기도 고양시 일산동구 식사동,1,주말,04시~05시,31 ,-,31 
경기도 고양시 일산동구 식사동,1,주말,05시~06시,52 ,8 ,60 
경기도 고양시 일산동구 식사동,1,주말,06시~07시,86 ,110 ,196 
경기도 고양시 일산동구 식사동,1,주말,07시~08시,147 ,132 ,279 
경기도 고양시 일산동구 식사동,1,주말,08시~09시,234 ,225 ,459 
경기도 고양시 일산동구 식사동,1,주말,09시~10시,300 ,214 ,514 
경기도 고양시 일산동구 식사동,1,주말,10시~11시,321 ,185 ,506 
경기도 고양시 일산동구 식사동,1,주말,11시~12시,371 ,163 ,534 
경기도 고양시 일산동구 식사동,1,주말,12시~13시,376 ,208 ,584 
경기도 고양시 일산동구 식사동,1,주말,13시~14시,348 ,227 ,575 
경기도 고양시 일산동구 식사동,1,주말,14시~15시,343 ,262 ,605 
경기도 고양시 일산동구 식사동,1,주말,15시~16시,352 ,275 ,627 
경기도 고양시 일산동구 식사동,1,주말,16시~17시,373 ,291 ,664 
경기도 고양시 일산동구 식사동,1,주말,17시~18시,294 ,317 ,611 
경기도 고양시 일산동구 식사동,1,주말,18시~19시,275 ,341 ,616 
경기도 고양시 일산동구 식사동,1,주말,19시~20시,184 ,354 ,538 
경기도 고양시 일산동구 식사동,1,주말,20시~21시,135 ,262 ,397 
경기도 고양시 일산동구 식사동,1,주말,21시~22시,181 ,285 ,466 
경기도 고양시 일산동구 식사동,1,주말,22시~23시,177 ,327 ,504 
경기도 고양시 일산동구 식사동,1,주말,23시~24시,70 ,243 ,313 
경기도 고양시 일산동구 식사동,1,주말,00시~01시,12 ,113 ,125 
경기도 고양시 일산동구 식사동,1,주말,주간,3734 ,2840 ,6574 
경기도 고양시 일산동구 식사동,1,주말,전일,4662 ,4557 ,9219 
경기도 고양시 일산동구 중산동,1,평일,01시~02시,4 ,40 ,44 
경기도 고양시 일산동구 중산동,1,평일,04시~05시,21 ,4 ,25 
경기도 고양시 일산동구 중산동,1,평일,05시~06시,160 ,45 ,205 
경기도 고양시 일산동구 중산동,1,평일,06시~07시,600 ,194 ,794 
경기도 고양시 일산동구 중산동,1,평일,07시~08시,1041 ,408 ,1449 
경기도 고양시 일산동구 중산동,1,평일,08시~09시,1296 ,879 ,2175 
경기도 고양시 일산동구 중산동,1,평일,09시~10시,902 ,485 ,1387 
경기도 고양시 일산동구 중산동,1,평일,10시~11시,578 ,336 ,914 
경기도 고양시 일산동구 중산동,1,평일,11시~12시,584 ,425 ,1009 
경기도 고양시 일산동구 중산동,1,평일,12시~13시,664 ,472 ,1136 
경기도 고양시 일산동구 중산동,1,평일,13시~14시,643 ,571 ,1214 
경기도 고양시 일산동구 중산동,1,평일,14시~15시,632 ,590 ,1222 
경기도 고양시 일산동구 중산동,1,평일,15시~16시,778 ,743 ,1521 
경기도 고양시 일산동구 중산동,1,평일,16시~17시,588 ,835 ,1423 
경기도 고양시 일산동구 중산동,1,평일,17시~18시,732 ,912 ,1644 
경기도 고양시 일산동구 중산동,1,평일,18시~19시,828 ,1148 ,1976 
경기도 고양시 일산동구 중산동,1,평일,19시~20시,522 ,1279 ,1801 
경기도 고양시 일산동구 중산동,1,평일,20시~21시,348 ,852 ,1200 
경기도 고양시 일산동구 중산동,1,평일,21시~22시,387 ,820 ,1207 
경기도 고양시 일산동구 중산동,1,평일,22시~23시,320 ,833 ,1153 
경기도 고양시 일산동구 중산동,1,평일,23시~24시,177 ,551 ,728 
경기도 고양시 일산동구 중산동,1,평일,00시~01시,43 ,211 ,254 
경기도 고양시 일산동구 중산동,1,평일,주간,9266 ,7804 ,17070 
경기도 고양시 일산동구 중산동,1,평일,전일,11848 ,12633 ,24481 
경기도 고양시 일산동구 중산동,1,주말,01시~02시,5 ,48 ,53 
경기도 고양시 일산동구 중산동,1,주말,04시~05시,19 ,4 ,23 
경기도 고양시 일산동구 중산동,1,주말,05시~06시,111 ,37 ,148 
경기도 고양시 일산동구 중산동,1,주말,06시~07시,224 ,137 ,361 
경기도 고양시 일산동구 중산동,1,주말,07시~08시,315 ,170 ,485 
경기도 고양시 일산동구 중산동,1,주말,08시~09시,621 ,377 ,998 
경기도 고양시 일산동구 중산동,1,주말,09시~10시,718 ,407 ,1125 
경기도 고양시 일산동구 중산동,1,주말,10시~11시,649 ,360 ,1009 
경기도 고양시 일산동구 중산동,1,주말,11시~12시,670 ,348 ,1018 
경기도 고양시 일산동구 중산동,1,주말,12시~13시,720 ,444 ,1164 
경기도 고양시 일산동구 중산동,1,주말,13시~14시,631 ,530 ,1161 
경기도 고양시 일산동구 중산동,1,주말,14시~15시,570 ,505 ,1075 
경기도 고양시 일산동구 중산동,1,주말,15시~16시,521 ,543 ,1064 
경기도 고양시 일산동구 중산동,1,주말,16시~17시,542 ,657 ,1199 
경기도 고양시 일산동구 중산동,1,주말,17시~18시,543 ,713 ,1256 
경기도 고양시 일산동구 중산동,1,주말,18시~19시,495 ,818 ,1313 
경기도 고양시 일산동구 중산동,1,주말,19시~20시,397 ,707 ,1104 
경기도 고양시 일산동구 중산동,1,주말,20시~21시,308 ,589 ,897 
경기도 고양시 일산동구 중산동,1,주말,21시~22시,302 ,718 ,1020 
경기도 고양시 일산동구 중산동,1,주말,22시~23시,237 ,679 ,916 
경기도 고양시 일산동구 중산동,1,주말,23시~24시,164 ,550 ,714 
경기도 고양시 일산동구 중산동,1,주말,00시~01시,50 ,264 ,314 
경기도 고양시 일산동구 중산동,1,주말,주간,6995 ,5872 ,12867 
경기도 고양시 일산동구 중산동,1,주말,전일,8812 ,9605 ,18417 
경기도 고양시 일산동구 정발산동,1,평일,01시~02시,23 ,39 ,62 
경기도 고양시 일산동구 정발산동,1,평일,04시~05시,10 ,-,10 
경기도 고양시 일산동구 정발산동,1,평일,05시~06시,71 ,27 ,98 
경기도 고양시 일산동구 정발산동,1,평일,06시~07시,205 ,89 ,294 
경기도 고양시 일산동구 정발산동,1,평일,07시~08시,451 ,226 ,677 
경기도 고양시 일산동구 정발산동,1,평일,08시~09시,707 ,669 ,1376 
경기도 고양시 일산동구 정발산동,1,평일,09시~10시,484 ,417 ,901 
경기도 고양시 일산동구 정발산동,1,평일,10시~11시,354 ,286 ,640 
경기도 고양시 일산동구 정발산동,1,평일,11시~12시,410 ,295 ,705 
경기도 고양시 일산동구 정발산동,1,평일,12시~13시,408 ,306 ,714 
경기도 고양시 일산동구 정발산동,1,평일,13시~14시,472 ,385 ,857 
경기도 고양시 일산동구 정발산동,1,평일,14시~15시,439 ,400 ,839 
경기도 고양시 일산동구 정발산동,1,평일,15시~16시,498 ,484 ,982 
경기도 고양시 일산동구 정발산동,1,평일,16시~17시,497 ,524 ,1021 
경기도 고양시 일산동구 정발산동,1,평일,17시~18시,570 ,618 ,1188 
경기도 고양시 일산동구 정발산동,1,평일,18시~19시,691 ,821 ,1512 
경기도 고양시 일산동구 정발산동,1,평일,19시~20시,520 ,815 ,1335 
경기도 고양시 일산동구 정발산동,1,평일,20시~21시,491 ,612 ,1103 
경기도 고양시 일산동구 정발산동,1,평일,21시~22시,500 ,605 ,1105 
경기도 고양시 일산동구 정발산동,1,평일,22시~23시,573 ,689 ,1262 
경기도 고양시 일산동구 정발산동,1,평일,23시~24시,430 ,466 ,896 
경기도 고양시 일산동구 정발산동,1,평일,00시~01시,146 ,205 ,351 
경기도 고양시 일산동구 정발산동,1,평일,주간,5981 ,5431 ,11412 
경기도 고양시 일산동구 정발산동,1,평일,전일,8950 ,8978 ,17928 
경기도 고양시 일산동구 정발산동,1,주말,01시~02시,21 ,28 ,49 
경기도 고양시 일산동구 정발산동,1,주말,04시~05시,6 ,-,6 
경기도 고양시 일산동구 정발산동,1,주말,05시~06시,65 ,25 ,90 
경기도 고양시 일산동구 정발산동,1,주말,06시~07시,154 ,70 ,224 
경기도 고양시 일산동구 정발산동,1,주말,07시~08시,182 ,84 ,266 
경기도 고양시 일산동구 정발산동,1,주말,08시~09시,315 ,214 ,529 
경기도 고양시 일산동구 정발산동,1,주말,09시~10시,356 ,251 ,607 
경기도 고양시 일산동구 정발산동,1,주말,10시~11시,292 ,198 ,490 
경기도 고양시 일산동구 정발산동,1,주말,11시~12시,314 ,253 ,567 
경기도 고양시 일산동구 정발산동,1,주말,12시~13시,457 ,297 ,754 
경기도 고양시 일산동구 정발산동,1,주말,13시~14시,398 ,387 ,785 
경기도 고양시 일산동구 정발산동,1,주말,14시~15시,377 ,349 ,726 
경기도 고양시 일산동구 정발산동,1,주말,15시~16시,423 ,404 ,827 
경기도 고양시 일산동구 정발산동,1,주말,16시~17시,467 ,430 ,897 
경기도 고양시 일산동구 정발산동,1,주말,17시~18시,431 ,517 ,948 
경기도 고양시 일산동구 정발산동,1,주말,18시~19시,467 ,630 ,1097 
경기도 고양시 일산동구 정발산동,1,주말,19시~20시,381 ,555 ,936 
경기도 고양시 일산동구 정발산동,1,주말,20시~21시,476 ,498 ,974 
경기도 고양시 일산동구 정발산동,1,주말,21시~22시,442 ,406 ,848 
경기도 고양시 일산동구 정발산동,1,주말,22시~23시,551 ,507 ,1058 
경기도 고양시 일산동구 정발산동,1,주말,23시~24시,429 ,374 ,803 
경기도 고양시 일산동구 정발산동,1,주말,00시~01시,185 ,195 ,380 
경기도 고양시 일산동구 정발산동,1,주말,주간,4479 ,4014 ,8493 
경기도 고양시 일산동구 정발산동,1,주말,전일,7189 ,6672 ,13861 
경기도 고양시 일산동구 풍산동,1,평일,01시~02시,-,13 ,13 
경기도 고양시 일산동구 풍산동,1,평일,04시~05시,17 ,-,17 
경기도 고양시 일산동구 풍산동,1,평일,05시~06시,139 ,19 ,158 
경기도 고양시 일산동구 풍산동,1,평일,06시~07시,417 ,76 ,493 
경기도 고양시 일산동구 풍산동,1,평일,07시~08시,1000 ,193 ,1193 
경기도 고양시 일산동구 풍산동,1,평일,08시~09시,950 ,406 ,1356 
경기도 고양시 일산동구 풍산동,1,평일,09시~10시,707 ,244 ,951 
경기도 고양시 일산동구 풍산동,1,평일,10시~11시,429 ,206 ,635 
경기도 고양시 일산동구 풍산동,1,평일,11시~12시,458 ,261 ,719 
경기도 고양시 일산동구 풍산동,1,평일,12시~13시,431 ,291 ,722 
경기도 고양시 일산동구 풍산동,1,평일,13시~14시,448 ,356 ,804 
경기도 고양시 일산동구 풍산동,1,평일,14시~15시,391 ,337 ,728 
경기도 고양시 일산동구 풍산동,1,평일,15시~16시,373 ,379 ,752 
경기도 고양시 일산동구 풍산동,1,평일,16시~17시,382 ,503 ,885 
경기도 고양시 일산동구 풍산동,1,평일,17시~18시,390 ,497 ,887 
경기도 고양시 일산동구 풍산동,1,평일,18시~19시,489 ,857 ,1346 
경기도 고양시 일산동구 풍산동,1,평일,19시~20시,222 ,826 ,1048 
경기도 고양시 일산동구 풍산동,1,평일,20시~21시,170 ,551 ,721 
경기도 고양시 일산동구 풍산동,1,평일,21시~22시,183 ,543 ,726 
경기도 고양시 일산동구 풍산동,1,평일,22시~23시,138 ,567 ,705 
경기도 고양시 일산동구 풍산동,1,평일,23시~24시,75 ,349 ,424 
경기도 고양시 일산동구 풍산동,1,평일,00시~01시,11 ,127 ,138 
경기도 고양시 일산동구 풍산동,1,평일,주간,6448 ,4530 ,10978 
경기도 고양시 일산동구 풍산동,1,평일,전일,7820 ,7601 ,15421 
경기도 고양시 일산동구 풍산동,1,주말,01시~02시,-,13 ,13 
경기도 고양시 일산동구 풍산동,1,주말,02시~03시,-,1 ,1 
경기도 고양시 일산동구 풍산동,1,주말,04시~05시,9 ,1 ,10 
경기도 고양시 일산동구 풍산동,1,주말,05시~06시,95 ,12 ,107 
경기도 고양시 일산동구 풍산동,1,주말,06시~07시,135 ,77 ,212 
경기도 고양시 일산동구 풍산동,1,주말,07시~08시,274 ,123 ,397 
경기도 고양시 일산동구 풍산동,1,주말,08시~09시,446 ,180 ,626 
경기도 고양시 일산동구 풍산동,1,주말,09시~10시,476 ,205 ,681 
경기도 고양시 일산동구 풍산동,1,주말,10시~11시,456 ,186 ,642 
경기도 고양시 일산동구 풍산동,1,주말,11시~12시,480 ,174 ,654 
경기도 고양시 일산동구 풍산동,1,주말,12시~13시,443 ,273 ,716 
경기도 고양시 일산동구 풍산동,1,주말,13시~14시,503 ,334 ,837 
경기도 고양시 일산동구 풍산동,1,주말,14시~15시,429 ,293 ,722 
경기도 고양시 일산동구 풍산동,1,주말,15시~16시,416 ,362 ,778 
경기도 고양시 일산동구 풍산동,1,주말,16시~17시,379 ,374 ,753 
경기도 고양시 일산동구 풍산동,1,주말,17시~18시,403 ,448 ,851 
경기도 고양시 일산동구 풍산동,1,주말,18시~19시,349 ,471 ,820 
경기도 고양시 일산동구 풍산동,1,주말,19시~20시,204 ,420 ,624 
경기도 고양시 일산동구 풍산동,1,주말,20시~21시,161 ,340 ,501 
경기도 고양시 일산동구 풍산동,1,주말,21시~22시,157 ,424 ,581 
경기도 고양시 일산동구 풍산동,1,주말,22시~23시,122 ,482 ,604 
경기도 고양시 일산동구 풍산동,1,주말,23시~24시,45 ,347 ,392 
경기도 고양시 일산동구 풍산동,1,주말,00시~01시,10 ,114 ,124 
경기도 고양시 일산동구 풍산동,1,주말,주간,5054 ,3423 ,8477 
경기도 고양시 일산동구 풍산동,1,주말,전일,5992 ,5654 ,11646 
경기도 고양시 일산동구 백석1동,1,평일,01시~02시,19 ,44 ,63 
경기도 고양시 일산동구 백석1동,1,평일,02시~03시,2 ,1 ,3 
경기도 고양시 일산동구 백석1동,1,평일,04시~05시,3 ,-,3 
경기도 고양시 일산동구 백석1동,1,평일,05시~06시,93 ,111 ,204 
경기도 고양시 일산동구 백석1동,1,평일,06시~07시,351 ,395 ,746 
경기도 고양시 일산동구 백석1동,1,평일,07시~08시,767 ,856 ,1623 
경기도 고양시 일산동구 백석1동,1,평일,08시~09시,1106 ,1797 ,2903 
경기도 고양시 일산동구 백석1동,1,평일,09시~10시,741 ,1087 ,1828 
경기도 고양시 일산동구 백석1동,1,평일,10시~11시,561 ,823 ,1384 
경기도 고양시 일산동구 백석1동,1,평일,11시~12시,625 ,787 ,1412 
경기도 고양시 일산동구 백석1동,1,평일,12시~13시,651 ,770 ,1421 
경기도 고양시 일산동구 백석1동,1,평일,13시~14시,637 ,931 ,1568 
경기도 고양시 일산동구 백석1동,1,평일,14시~15시,711 ,867 ,1578 
경기도 고양시 일산동구 백석1동,1,평일,15시~16시,780 ,873 ,1653 
경기도 고양시 일산동구 백석1동,1,평일,16시~17시,816 ,961 ,1777 
경기도 고양시 일산동구 백석1동,1,평일,17시~18시,1121 ,1042 ,2163 
경기도 고양시 일산동구 백석1동,1,평일,18시~19시,1528 ,1495 ,3023 
경기도 고양시 일산동구 백석1동,1,평일,19시~20시,1024 ,1459 ,2483 
경기도 고양시 일산동구 백석1동,1,평일,20시~21시,772 ,1089 ,1861 
경기도 고양시 일산동구 백석1동,1,평일,21시~22시,720 ,932 ,1652 
경기도 고양시 일산동구 백석1동,1,평일,22시~23시,649 ,937 ,1586 
경기도 고양시 일산동구 백석1동,1,평일,23시~24시,393 ,642 ,1035 
경기도 고양시 일산동구 백석1동,1,평일,00시~01시,136 ,256 ,392 
경기도 고양시 일산동구 백석1동,1,평일,주간,10044 ,12289 ,22333 
경기도 고양시 일산동구 백석1동,1,평일,전일,14206 ,18155 ,32361 
경기도 고양시 일산동구 백석1동,1,주말,01시~02시,11 ,47 ,58 
경기도 고양시 일산동구 백석1동,1,주말,02시~03시,-,5 ,5 
경기도 고양시 일산동구 백석1동,1,주말,04시~05시,5 ,5 ,10 
경기도 고양시 일산동구 백석1동,1,주말,05시~06시,51 ,89 ,140 
경기도 고양시 일산동구 백석1동,1,주말,06시~07시,144 ,241 ,385 
경기도 고양시 일산동구 백석1동,1,주말,07시~08시,280 ,367 ,647 
경기도 고양시 일산동구 백석1동,1,주말,08시~09시,419 ,603 ,1022 
경기도 고양시 일산동구 백석1동,1,주말,09시~10시,485 ,713 ,1198 
경기도 고양시 일산동구 백석1동,1,주말,10시~11시,460 ,714 ,1174 
경기도 고양시 일산동구 백석1동,1,주말,11시~12시,517 ,720 ,1237 
경기도 고양시 일산동구 백석1동,1,주말,12시~13시,661 ,932 ,1593 
경기도 고양시 일산동구 백석1동,1,주말,13시~14시,700 ,813 ,1513 
경기도 고양시 일산동구 백석1동,1,주말,14시~15시,563 ,793 ,1356 
경기도 고양시 일산동구 백석1동,1,주말,15시~16시,693 ,903 ,1596 
경기도 고양시 일산동구 백석1동,1,주말,16시~17시,781 ,915 ,1696 
경기도 고양시 일산동구 백석1동,1,주말,17시~18시,796 ,999 ,1795 
경기도 고양시 일산동구 백석1동,1,주말,18시~19시,807 ,980 ,1787 
경기도 고양시 일산동구 백석1동,1,주말,19시~20시,640 ,829 ,1469 
경기도 고양시 일산동구 백석1동,1,주말,20시~21시,599 ,666 ,1265 
경기도 고양시 일산동구 백석1동,1,주말,21시~22시,538 ,711 ,1249 
경기도 고양시 일산동구 백석1동,1,주말,22시~23시,703 ,688 ,1391 
경기도 고양시 일산동구 백석1동,1,주말,23시~24시,414 ,527 ,941 
경기도 고양시 일산동구 백석1동,1,주말,00시~01시,146 ,291 ,437 
경기도 고양시 일산동구 백석1동,1,주말,주간,7162 ,9452 ,16614 
경기도 고양시 일산동구 백석1동,1,주말,전일,10413 ,13551 ,23964 
경기도 고양시 일산동구 마두1동,1,평일,01시~02시,19 ,31 ,50 
경기도 고양시 일산동구 마두1동,1,평일,02시~03시,-,4 ,4 
경기도 고양시 일산동구 마두1동,1,평일,05시~06시,78 ,95 ,173 
경기도 고양시 일산동구 마두1동,1,평일,06시~07시,289 ,374 ,663 
경기도 고양시 일산동구 마두1동,1,평일,07시~08시,516 ,1046 ,1562 
경기도 고양시 일산동구 마두1동,1,평일,08시~09시,1019 ,1581 ,2600 
경기도 고양시 일산동구 마두1동,1,평일,09시~10시,789 ,1297 ,2086 
경기도 고양시 일산동구 마두1동,1,평일,10시~11시,633 ,800 ,1433 
경기도 고양시 일산동구 마두1동,1,평일,11시~12시,698 ,874 ,1572 
경기도 고양시 일산동구 마두1동,1,평일,12시~13시,752 ,853 ,1605 
경기도 고양시 일산동구 마두1동,1,평일,13시~14시,894 ,1002 ,1896 
경기도 고양시 일산동구 마두1동,1,평일,14시~15시,884 ,916 ,1800 
경기도 고양시 일산동구 마두1동,1,평일,15시~16시,993 ,872 ,1865 
경기도 고양시 일산동구 마두1동,1,평일,16시~17시,1091 ,981 ,2072 
경기도 고양시 일산동구 마두1동,1,평일,17시~18시,1415 ,1160 ,2575 
경기도 고양시 일산동구 마두1동,1,평일,18시~19시,1937 ,1380 ,3317 
경기도 고양시 일산동구 마두1동,1,평일,19시~20시,1512 ,1059 ,2571 
경기도 고양시 일산동구 마두1동,1,평일,20시~21시,1227 ,782 ,2009 
경기도 고양시 일산동구 마두1동,1,평일,21시~22시,1163 ,619 ,1782 
경기도 고양시 일산동구 마두1동,1,평일,22시~23시,1192 ,664 ,1856 
경기도 고양시 일산동구 마두1동,1,평일,23시~24시,577 ,400 ,977 
경기도 고양시 일산동구 마두1동,1,평일,00시~01시,176 ,169 ,345 
경기도 고양시 일산동구 마두1동,1,평일,주간,11621 ,12762 ,24383 
경기도 고양시 일산동구 마두1동,1,평일,전일,17854 ,16959 ,34813 
경기도 고양시 일산동구 마두1동,1,주말,01시~02시,15 ,31 ,46 
경기도 고양시 일산동구 마두1동,1,주말,02시~03시,-,3 ,3 
경기도 고양시 일산동구 마두1동,1,주말,04시~05시,5 ,-,5 
경기도 고양시 일산동구 마두1동,1,주말,05시~06시,42 ,69 ,111 
경기도 고양시 일산동구 마두1동,1,주말,06시~07시,152 ,133 ,285 
경기도 고양시 일산동구 마두1동,1,주말,07시~08시,228 ,265 ,493 
경기도 고양시 일산동구 마두1동,1,주말,08시~09시,427 ,478 ,905 
경기도 고양시 일산동구 마두1동,1,주말,09시~10시,551 ,689 ,1240 
경기도 고양시 일산동구 마두1동,1,주말,10시~11시,476 ,727 ,1203 
경기도 고양시 일산동구 마두1동,1,주말,11시~12시,525 ,761 ,1286 
경기도 고양시 일산동구 마두1동,1,주말,12시~13시,699 ,873 ,1572 
경기도 고양시 일산동구 마두1동,1,주말,13시~14시,768 ,969 ,1737 
경기도 고양시 일산동구 마두1동,1,주말,14시~15시,805 ,896 ,1701 
경기도 고양시 일산동구 마두1동,1,주말,15시~16시,852 ,896 ,1748 
경기도 고양시 일산동구 마두1동,1,주말,16시~17시,999 ,961 ,1960 
경기도 고양시 일산동구 마두1동,1,주말,17시~18시,1165 ,978 ,2143 
경기도 고양시 일산동구 마두1동,1,주말,18시~19시,1087 ,1004 ,2091 
경기도 고양시 일산동구 마두1동,1,주말,19시~20시,863 ,759 ,1622 
경기도 고양시 일산동구 마두1동,1,주말,20시~21시,838 ,585 ,1423 
경기도 고양시 일산동구 마두1동,1,주말,21시~22시,881 ,536 ,1417 
경기도 고양시 일산동구 마두1동,1,주말,22시~23시,1040 ,571 ,1611 
경기도 고양시 일산동구 마두1동,1,주말,23시~24시,598 ,369 ,967 
경기도 고양시 일산동구 마두1동,1,주말,00시~01시,190 ,199 ,389 
경기도 고양시 일산동구 마두1동,1,주말,주간,8582 ,9497 ,18079 
경기도 고양시 일산동구 마두1동,1,주말,전일,13206 ,12752 ,25958 
경기도 고양시 일산동구 마두2동,1,평일,01시~02시,6 ,23 ,29 
경기도 고양시 일산동구 마두2동,1,평일,05시~06시,15 ,28 ,43 
경기도 고양시 일산동구 마두2동,1,평일,06시~07시,116 ,193 ,309 
경기도 고양시 일산동구 마두2동,1,평일,07시~08시,216 ,384 ,600 
경기도 고양시 일산동구 마두2동,1,평일,08시~09시,371 ,702 ,1073 
경기도 고양시 일산동구 마두2동,1,평일,09시~10시,286 ,693 ,979 
경기도 고양시 일산동구 마두2동,1,평일,10시~11시,211 ,417 ,628 
경기도 고양시 일산동구 마두2동,1,평일,11시~12시,306 ,429 ,735 
경기도 고양시 일산동구 마두2동,1,평일,12시~13시,362 ,482 ,844 
경기도 고양시 일산동구 마두2동,1,평일,13시~14시,343 ,495 ,838 
경기도 고양시 일산동구 마두2동,1,평일,14시~15시,349 ,441 ,790 
경기도 고양시 일산동구 마두2동,1,평일,15시~16시,431 ,497 ,928 
경기도 고양시 일산동구 마두2동,1,평일,16시~17시,502 ,463 ,965 
경기도 고양시 일산동구 마두2동,1,평일,17시~18시,506 ,492 ,998 
경기도 고양시 일산동구 마두2동,1,평일,18시~19시,604 ,621 ,1225 
경기도 고양시 일산동구 마두2동,1,평일,19시~20시,504 ,599 ,1103 
경기도 고양시 일산동구 마두2동,1,평일,20시~21시,339 ,464 ,803 
경기도 고양시 일산동구 마두2동,1,평일,21시~22시,376 ,364 ,740 
경기도 고양시 일산동구 마두2동,1,평일,22시~23시,363 ,381 ,744 
경기도 고양시 일산동구 마두2동,1,평일,23시~24시,171 ,290 ,461 
경기도 고양시 일산동구 마두2동,1,평일,00시~01시,63 ,96 ,159 
경기도 고양시 일산동구 마두2동,1,평일,주간,4487 ,6116 ,10603 
경기도 고양시 일산동구 마두2동,1,평일,전일,6440 ,8554 ,14994 
경기도 고양시 일산동구 마두2동,1,주말,01시~02시,10 ,15 ,25 
경기도 고양시 일산동구 마두2동,1,주말,02시~03시,-,3 ,3 
경기도 고양시 일산동구 마두2동,1,주말,04시~05시,1 ,-,1 
경기도 고양시 일산동구 마두2동,1,주말,05시~06시,8 ,14 ,22 
경기도 고양시 일산동구 마두2동,1,주말,06시~07시,69 ,102 ,171 
경기도 고양시 일산동구 마두2동,1,주말,07시~08시,93 ,173 ,266 
경기도 고양시 일산동구 마두2동,1,주말,08시~09시,151 ,318 ,469 
경기도 고양시 일산동구 마두2동,1,주말,09시~10시,236 ,420 ,656 
경기도 고양시 일산동구 마두2동,1,주말,10시~11시,229 ,441 ,670 
경기도 고양시 일산동구 마두2동,1,주말,11시~12시,314 ,470 ,784 
경기도 고양시 일산동구 마두2동,1,주말,12시~13시,295 ,512 ,807 
경기도 고양시 일산동구 마두2동,1,주말,13시~14시,384 ,569 ,953 
경기도 고양시 일산동구 마두2동,1,주말,14시~15시,333 ,452 ,785 
경기도 고양시 일산동구 마두2동,1,주말,15시~16시,381 ,469 ,850 
경기도 고양시 일산동구 마두2동,1,주말,16시~17시,399 ,456 ,855 
경기도 고양시 일산동구 마두2동,1,주말,17시~18시,414 ,413 ,827 
경기도 고양시 일산동구 마두2동,1,주말,18시~19시,414 ,433 ,847 
경기도 고양시 일산동구 마두2동,1,주말,19시~20시,387 ,329 ,716 
경기도 고양시 일산동구 마두2동,1,주말,20시~21시,253 ,266 ,519 
경기도 고양시 일산동구 마두2동,1,주말,21시~22시,265 ,297 ,562 
경기도 고양시 일산동구 마두2동,1,주말,22시~23시,256 ,302 ,558 
경기도 고양시 일산동구 마두2동,1,주말,23시~24시,162 ,256 ,418 
경기도 고양시 일산동구 마두2동,1,주말,00시~01시,58 ,155 ,213 
경기도 고양시 일산동구 마두2동,1,주말,주간,3643 ,5126 ,8769 
경기도 고양시 일산동구 마두2동,1,주말,전일,5112 ,6865 ,11977 
경기도 고양시 일산동구 장항1동,1,평일,05시~06시,2 ,-,2 
경기도 고양시 일산동구 장항1동,1,평일,06시~07시,11 ,35 ,46 
경기도 고양시 일산동구 장항1동,1,평일,07시~08시,12 ,63 ,75 
경기도 고양시 일산동구 장항1동,1,평일,08시~09시,26 ,156 ,182 
경기도 고양시 일산동구 장항1동,1,평일,09시~10시,15 ,92 ,107 
경기도 고양시 일산동구 장항1동,1,평일,10시~11시,12 ,43 ,55 
경기도 고양시 일산동구 장항1동,1,평일,11시~12시,21 ,17 ,38 
경기도 고양시 일산동구 장항1동,1,평일,12시~13시,17 ,30 ,47 
경기도 고양시 일산동구 장항1동,1,평일,13시~14시,13 ,38 ,51 
경기도 고양시 일산동구 장항1동,1,평일,14시~15시,21 ,25 ,46 
경기도 고양시 일산동구 장항1동,1,평일,15시~16시,32 ,21 ,53 
경기도 고양시 일산동구 장항1동,1,평일,16시~17시,36 ,25 ,61 
경기도 고양시 일산동구 장항1동,1,평일,17시~18시,75 ,34 ,109 
경기도 고양시 일산동구 장항1동,1,평일,18시~19시,147 ,24 ,171 
경기도 고양시 일산동구 장항1동,1,평일,19시~20시,61 ,27 ,88 
경기도 고양시 일산동구 장항1동,1,평일,20시~21시,30 ,8 ,38 
경기도 고양시 일산동구 장항1동,1,평일,21시~22시,34 ,12 ,46 
경기도 고양시 일산동구 장항1동,1,평일,22시~23시,8 ,7 ,15 
경기도 고양시 일산동구 장항1동,1,평일,23시~24시,7 ,1 ,8 
경기도 고양시 일산동구 장항1동,1,평일,주간,427 ,568 ,995 
경기도 고양시 일산동구 장항1동,1,평일,전일,580 ,658 ,1238 
경기도 고양시 일산동구 장항1동,1,주말,06시~07시,3 ,18 ,21 
경기도 고양시 일산동구 장항1동,1,주말,07시~08시,3 ,36 ,39 
경기도 고양시 일산동구 장항1동,1,주말,08시~09시,11 ,47 ,58 
경기도 고양시 일산동구 장항1동,1,주말,09시~10시,12 ,29 ,41 
경기도 고양시 일산동구 장항1동,1,주말,10시~11시,12 ,18 ,30 
경기도 고양시 일산동구 장항1동,1,주말,11시~12시,12 ,17 ,29 
경기도 고양시 일산동구 장항1동,1,주말,12시~13시,17 ,15 ,32 
경기도 고양시 일산동구 장항1동,1,주말,13시~14시,18 ,22 ,40 
경기도 고양시 일산동구 장항1동,1,주말,14시~15시,14 ,29 ,43 
경기도 고양시 일산동구 장항1동,1,주말,15시~16시,30 ,29 ,59 
경기도 고양시 일산동구 장항1동,1,주말,16시~17시,30 ,37 ,67 
경기도 고양시 일산동구 장항1동,1,주말,17시~18시,22 ,13 ,35 
경기도 고양시 일산동구 장항1동,1,주말,18시~19시,39 ,17 ,56 
경기도 고양시 일산동구 장항1동,1,주말,19시~20시,18 ,13 ,31 
경기도 고양시 일산동구 장항1동,1,주말,20시~21시,21 ,7 ,28 
경기도 고양시 일산동구 장항1동,1,주말,21시~22시,23 ,5 ,28 
경기도 고양시 일산동구 장항1동,1,주말,22시~23시,4 ,7 ,11 
경기도 고양시 일산동구 장항1동,1,주말,23시~24시,4 ,3 ,7 
경기도 고양시 일산동구 장항1동,1,주말,주간,220 ,309 ,529 
경기도 고양시 일산동구 장항1동,1,주말,전일,293 ,362 ,655 
경기도 고양시 일산동구 장항2동,1,평일,01시~02시,1 ,5 ,6 
경기도 고양시 일산동구 장항2동,1,평일,04시~05시,48 ,22 ,70 
경기도 고양시 일산동구 장항2동,1,평일,05시~06시,288 ,163 ,451 
경기도 고양시 일산동구 장항2동,1,평일,06시~07시,653 ,403 ,1056 
경기도 고양시 일산동구 장항2동,1,평일,07시~08시,996 ,698 ,1694 
경기도 고양시 일산동구 장항2동,1,평일,08시~09시,1030 ,1866 ,2896 
경기도 고양시 일산동구 장항2동,1,평일,09시~10시,808 ,1853 ,2661 
경기도 고양시 일산동구 장항2동,1,평일,10시~11시,752 ,1178 ,1930 
경기도 고양시 일산동구 장항2동,1,평일,11시~12시,835 ,1213 ,2048 
경기도 고양시 일산동구 장항2동,1,평일,12시~13시,866 ,1148 ,2014 
경기도 고양시 일산동구 장항2동,1,평일,13시~14시,987 ,1174 ,2161 
경기도 고양시 일산동구 장항2동,1,평일,14시~15시,1140 ,1146 ,2286 
경기도 고양시 일산동구 장항2동,1,평일,15시~16시,1174 ,1143 ,2317 
경기도 고양시 일산동구 장항2동,1,평일,16시~17시,1284 ,1112 ,2396 
경기도 고양시 일산동구 장항2동,1,평일,17시~18시,1564 ,1338 ,2902 
경기도 고양시 일산동구 장항2동,1,평일,18시~19시,1932 ,1443 ,3375 
경기도 고양시 일산동구 장항2동,1,평일,19시~20시,1226 ,1115 ,2341 
경기도 고양시 일산동구 장항2동,1,평일,20시~21시,1180 ,733 ,1913 
경기도 고양시 일산동구 장항2동,1,평일,21시~22시,1258 ,580 ,1838 
경기도 고양시 일산동구 장항2동,1,평일,22시~23시,1185 ,554 ,1739 
경기도 고양시 일산동구 장항2동,1,평일,23시~24시,577 ,369 ,946 
경기도 고양시 일산동구 장항2동,1,평일,00시~01시,157 ,111 ,268 
경기도 고양시 일산동구 장항2동,1,평일,주간,13368 ,15312 ,28680 
경기도 고양시 일산동구 장항2동,1,평일,전일,19941 ,19367 ,39308 
경기도 고양시 일산동구 장항2동,1,주말,01시~02시,2 ,2 ,4 
경기도 고양시 일산동구 장항2동,1,주말,04시~05시,70 ,19 ,89 
경기도 고양시 일산동구 장항2동,1,주말,05시~06시,253 ,145 ,398 
경기도 고양시 일산동구 장항2동,1,주말,06시~07시,264 ,270 ,534 
경기도 고양시 일산동구 장항2동,1,주말,07시~08시,335 ,329 ,664 
경기도 고양시 일산동구 장항2동,1,주말,08시~09시,588 ,825 ,1413 
경기도 고양시 일산동구 장항2동,1,주말,09시~10시,635 ,1149 ,1784 
경기도 고양시 일산동구 장항2동,1,주말,10시~11시,717 ,1190 ,1907 
경기도 고양시 일산동구 장항2동,1,주말,11시~12시,849 ,1292 ,2141 
경기도 고양시 일산동구 장항2동,1,주말,12시~13시,923 ,1312 ,2235 
경기도 고양시 일산동구 장항2동,1,주말,13시~14시,1030 ,1463 ,2493 
경기도 고양시 일산동구 장항2동,1,주말,14시~15시,934 ,1400 ,2334 
경기도 고양시 일산동구 장항2동,1,주말,15시~16시,1215 ,1330 ,2545 
경기도 고양시 일산동구 장항2동,1,주말,16시~17시,1324 ,1375 ,2699 
경기도 고양시 일산동구 장항2동,1,주말,17시~18시,1420 ,1276 ,2696 
경기도 고양시 일산동구 장항2동,1,주말,18시~19시,1407 ,1428 ,2835 
경기도 고양시 일산동구 장항2동,1,주말,19시~20시,1018 ,1085 ,2103 
경기도 고양시 일산동구 장항2동,1,주말,20시~21시,1129 ,817 ,1946 
경기도 고양시 일산동구 장항2동,1,주말,21시~22시,1137 ,619 ,1756 
경기도 고양시 일산동구 장항2동,1,주말,22시~23시,1053 ,500 ,1553 
경기도 고양시 일산동구 장항2동,1,주말,23시~24시,648 ,315 ,963 
경기도 고양시 일산동구 장항2동,1,주말,00시~01시,208 ,120 ,328 
경기도 고양시 일산동구 장항2동,1,주말,주간,11377 ,14369 ,25746 
경기도 고양시 일산동구 장항2동,1,주말,전일,17159 ,18261 ,35420 
경기도 고양시 일산동구 고봉동,1,평일,04시~05시,10 ,-,10 
경기도 고양시 일산동구 고봉동,1,평일,05시~06시,83 ,20 ,103 
경기도 고양시 일산동구 고봉동,1,평일,06시~07시,212 ,92 ,304 
경기도 고양시 일산동구 고봉동,1,평일,07시~08시,457 ,317 ,774 
경기도 고양시 일산동구 고봉동,1,평일,08시~09시,503 ,685 ,1188 
경기도 고양시 일산동구 고봉동,1,평일,09시~10시,326 ,236 ,562 
경기도 고양시 일산동구 고봉동,1,평일,10시~11시,287 ,141 ,428 
경기도 고양시 일산동구 고봉동,1,평일,11시~12시,248 ,121 ,369 
경기도 고양시 일산동구 고봉동,1,평일,12시~13시,288 ,173 ,461 
경기도 고양시 일산동구 고봉동,1,평일,13시~14시,246 ,153 ,399 
경기도 고양시 일산동구 고봉동,1,평일,14시~15시,274 ,168 ,442 
경기도 고양시 일산동구 고봉동,1,평일,15시~16시,237 ,221 ,458 
경기도 고양시 일산동구 고봉동,1,평일,16시~17시,230 ,237 ,467 
경기도 고양시 일산동구 고봉동,1,평일,17시~18시,328 ,286 ,614 
경기도 고양시 일산동구 고봉동,1,평일,18시~19시,465 ,312 ,777 
경기도 고양시 일산동구 고봉동,1,평일,19시~20시,183 ,328 ,511 
경기도 고양시 일산동구 고봉동,1,평일,20시~21시,100 ,261 ,361 
경기도 고양시 일산동구 고봉동,1,평일,21시~22시,96 ,181 ,277 
경기도 고양시 일산동구 고봉동,1,평일,22시~23시,66 ,190 ,256 
경기도 고양시 일산동구 고봉동,1,평일,23시~24시,30 ,137 ,167 
경기도 고양시 일산동구 고봉동,1,평일,00시~01시,5 ,42 ,47 
경기도 고양시 일산동구 고봉동,1,평일,주간,3889 ,3050 ,6939 
경기도 고양시 일산동구 고봉동,1,평일,전일,4674 ,4301 ,8975 
경기도 고양시 일산동구 고봉동,1,주말,01시~02시,-,1 ,1 
경기도 고양시 일산동구 고봉동,1,주말,04시~05시,8 ,-,8 
경기도 고양시 일산동구 고봉동,1,주말,05시~06시,58 ,22 ,80 
경기도 고양시 일산동구 고봉동,1,주말,06시~07시,90 ,67 ,157 
경기도 고양시 일산동구 고봉동,1,주말,07시~08시,176 ,158 ,334 
경기도 고양시 일산동구 고봉동,1,주말,08시~09시,267 ,199 ,466 
경기도 고양시 일산동구 고봉동,1,주말,09시~10시,293 ,174 ,467 
경기도 고양시 일산동구 고봉동,1,주말,10시~11시,339 ,126 ,465 
경기도 고양시 일산동구 고봉동,1,주말,11시~12시,260 ,125 ,385 
경기도 고양시 일산동구 고봉동,1,주말,12시~13시,264 ,173 ,437 
경기도 고양시 일산동구 고봉동,1,주말,13시~14시,256 ,154 ,410 
경기도 고양시 일산동구 고봉동,1,주말,14시~15시,214 ,145 ,359 
경기도 고양시 일산동구 고봉동,1,주말,15시~16시,244 ,160 ,404 
경기도 고양시 일산동구 고봉동,1,주말,16시~17시,223 ,231 ,454 
경기도 고양시 일산동구 고봉동,1,주말,17시~18시,297 ,192 ,489 
경기도 고양시 일산동구 고봉동,1,주말,18시~19시,196 ,196 ,392 
경기도 고양시 일산동구 고봉동,1,주말,19시~20시,98 ,193 ,291 
경기도 고양시 일산동구 고봉동,1,주말,20시~21시,113 ,183 ,296 
경기도 고양시 일산동구 고봉동,1,주말,21시~22시,98 ,173 ,271 
경기도 고양시 일산동구 고봉동,1,주말,22시~23시,57 ,166 ,223 
경기도 고양시 일산동구 고봉동,1,주말,23시~24시,18 ,134 ,152 
경기도 고양시 일산동구 고봉동,1,주말,00시~01시,1 ,40 ,41 
경기도 고양시 일산동구 고봉동,1,주말,주간,3029 ,2033 ,5062 
경기도 고양시 일산동구 고봉동,1,주말,전일,3570 ,3012 ,6582 
경기도 고양시 일산동구 백석2동,1,평일,01시~02시,7 ,14 ,21 
경기도 고양시 일산동구 백석2동,1,평일,04시~05시,13 ,3 ,16 
경기도 고양시 일산동구 백석2동,1,평일,05시~06시,113 ,29 ,142 
경기도 고양시 일산동구 백석2동,1,평일,06시~07시,347 ,73 ,420 
경기도 고양시 일산동구 백석2동,1,평일,07시~08시,643 ,193 ,836 
경기도 고양시 일산동구 백석2동,1,평일,08시~09시,693 ,469 ,1162 
경기도 고양시 일산동구 백석2동,1,평일,09시~10시,488 ,278 ,766 
경기도 고양시 일산동구 백석2동,1,평일,10시~11시,356 ,233 ,589 
경기도 고양시 일산동구 백석2동,1,평일,11시~12시,382 ,213 ,595 
경기도 고양시 일산동구 백석2동,1,평일,12시~13시,396 ,240 ,636 
경기도 고양시 일산동구 백석2동,1,평일,13시~14시,440 ,228 ,668 
경기도 고양시 일산동구 백석2동,1,평일,14시~15시,339 ,230 ,569 
경기도 고양시 일산동구 백석2동,1,평일,15시~16시,465 ,237 ,702 
경기도 고양시 일산동구 백석2동,1,평일,16시~17시,413 ,265 ,678 
경기도 고양시 일산동구 백석2동,1,평일,17시~18시,635 ,305 ,940 
경기도 고양시 일산동구 백석2동,1,평일,18시~19시,697 ,404 ,1101 
경기도 고양시 일산동구 백석2동,1,평일,19시~20시,454 ,303 ,757 
경기도 고양시 일산동구 백석2동,1,평일,20시~21시,356 ,204 ,560 
경기도 고양시 일산동구 백석2동,1,평일,21시~22시,367 ,251 ,618 
경기도 고양시 일산동구 백석2동,1,평일,22시~23시,335 ,222 ,557 
경기도 고양시 일산동구 백석2동,1,평일,23시~24시,169 ,136 ,305 
경기도 고양시 일산동구 백석2동,1,평일,00시~01시,37 ,62 ,99 
경기도 고양시 일산동구 백석2동,1,평일,주간,5947 ,3295 ,9242 
경기도 고양시 일산동구 백석2동,1,평일,전일,8145 ,4592 ,12737 
경기도 고양시 일산동구 백석2동,1,주말,01시~02시,3 ,3 ,6 
경기도 고양시 일산동구 백석2동,1,주말,04시~05시,11 ,5 ,16 
경기도 고양시 일산동구 백석2동,1,주말,05시~06시,79 ,48 ,127 
경기도 고양시 일산동구 백석2동,1,주말,06시~07시,117 ,64 ,181 
경기도 고양시 일산동구 백석2동,1,주말,07시~08시,193 ,121 ,314 
경기도 고양시 일산동구 백석2동,1,주말,08시~09시,356 ,188 ,544 
경기도 고양시 일산동구 백석2동,1,주말,09시~10시,338 ,177 ,515 
경기도 고양시 일산동구 백석2동,1,주말,10시~11시,357 ,159 ,516 
경기도 고양시 일산동구 백석2동,1,주말,11시~12시,438 ,191 ,629 
경기도 고양시 일산동구 백석2동,1,주말,12시~13시,492 ,223 ,715 
경기도 고양시 일산동구 백석2동,1,주말,13시~14시,448 ,238 ,686 
경기도 고양시 일산동구 백석2동,1,주말,14시~15시,425 ,226 ,651 
경기도 고양시 일산동구 백석2동,1,주말,15시~16시,440 ,254 ,694 
경기도 고양시 일산동구 백석2동,1,주말,16시~17시,449 ,223 ,672 
경기도 고양시 일산동구 백석2동,1,주말,17시~18시,521 ,304 ,825 
경기도 고양시 일산동구 백석2동,1,주말,18시~19시,394 ,259 ,653 
경기도 고양시 일산동구 백석2동,1,주말,19시~20시,321 ,201 ,522 
경기도 고양시 일산동구 백석2동,1,주말,20시~21시,319 ,198 ,517 
경기도 고양시 일산동구 백석2동,1,주말,21시~22시,294 ,176 ,470 
경기도 고양시 일산동구 백석2동,1,주말,22시~23시,344 ,167 ,511 
경기도 고양시 일산동구 백석2동,1,주말,23시~24시,153 ,119 ,272 
경기도 고양시 일산동구 백석2동,1,주말,00시~01시,29 ,59 ,88 
경기도 고양시 일산동구 백석2동,1,주말,주간,4851 ,2563 ,7414 
경기도 고양시 일산동구 백석2동,1,주말,전일,6521 ,3603 ,10124 
경기도 고양시 일산서구 일산1동,1,평일,04시~05시,2 ,-,2 
경기도 고양시 일산서구 일산1동,1,평일,05시~06시,19 ,3 ,22 
경기도 고양시 일산서구 일산1동,1,평일,06시~07시,105 ,35 ,140 
경기도 고양시 일산서구 일산1동,1,평일,07시~08시,219 ,49 ,268 
경기도 고양시 일산서구 일산1동,1,평일,08시~09시,377 ,178 ,555 
경기도 고양시 일산서구 일산1동,1,평일,09시~10시,166 ,127 ,293 
경기도 고양시 일산서구 일산1동,1,평일,10시~11시,215 ,124 ,339 
경기도 고양시 일산서구 일산1동,1,평일,11시~12시,168 ,167 ,335 
경기도 고양시 일산서구 일산1동,1,평일,12시~13시,196 ,185 ,381 
경기도 고양시 일산서구 일산1동,1,평일,13시~14시,195 ,119 ,314 
경기도 고양시 일산서구 일산1동,1,평일,14시~15시,193 ,128 ,321 
경기도 고양시 일산서구 일산1동,1,평일,15시~16시,219 ,198 ,417 
경기도 고양시 일산서구 일산1동,1,평일,16시~17시,134 ,188 ,322 
경기도 고양시 일산서구 일산1동,1,평일,17시~18시,148 ,193 ,341 
경기도 고양시 일산서구 일산1동,1,평일,18시~19시,146 ,236 ,382 
경기도 고양시 일산서구 일산1동,1,평일,19시~20시,64 ,223 ,287 
경기도 고양시 일산서구 일산1동,1,평일,20시~21시,67 ,162 ,229 
경기도 고양시 일산서구 일산1동,1,평일,21시~22시,53 ,162 ,215 
경기도 고양시 일산서구 일산1동,1,평일,22시~23시,25 ,153 ,178 
경기도 고양시 일산서구 일산1동,1,평일,23시~24시,21 ,88 ,109 
경기도 고양시 일산서구 일산1동,1,평일,00시~01시,4 ,20 ,24 
경기도 고양시 일산서구 일산1동,1,평일,주간,2376 ,1892 ,4268 
경기도 고양시 일산서구 일산1동,1,평일,전일,2736 ,2738 ,5474 
경기도 고양시 일산서구 일산1동,1,주말,04시~05시,1 ,-,1 
경기도 고양시 일산서구 일산1동,1,주말,05시~06시,11 ,4 ,15 
경기도 고양시 일산서구 일산1동,1,주말,06시~07시,57 ,33 ,90 
경기도 고양시 일산서구 일산1동,1,주말,07시~08시,73 ,27 ,100 
경기도 고양시 일산서구 일산1동,1,주말,08시~09시,140 ,49 ,189 
경기도 고양시 일산서구 일산1동,1,주말,09시~10시,159 ,37 ,196 
경기도 고양시 일산서구 일산1동,1,주말,10시~11시,137 ,68 ,205 
경기도 고양시 일산서구 일산1동,1,주말,11시~12시,146 ,88 ,234 
경기도 고양시 일산서구 일산1동,1,주말,12시~13시,137 ,89 ,226 
경기도 고양시 일산서구 일산1동,1,주말,13시~14시,118 ,97 ,215 
경기도 고양시 일산서구 일산1동,1,주말,14시~15시,109 ,107 ,216 
경기도 고양시 일산서구 일산1동,1,주말,15시~16시,108 ,107 ,215 
경기도 고양시 일산서구 일산1동,1,주말,16시~17시,83 ,148 ,231 
경기도 고양시 일산서구 일산1동,1,주말,17시~18시,118 ,145 ,263 
경기도 고양시 일산서구 일산1동,1,주말,18시~19시,121 ,158 ,279 
경기도 고양시 일산서구 일산1동,1,주말,19시~20시,63 ,107 ,170 
경기도 고양시 일산서구 일산1동,1,주말,20시~21시,42 ,108 ,150 
경기도 고양시 일산서구 일산1동,1,주말,21시~22시,41 ,133 ,174 
경기도 고양시 일산서구 일산1동,1,주말,22시~23시,37 ,148 ,185 
경기도 고양시 일산서구 일산1동,1,주말,23시~24시,20 ,86 ,106 
경기도 고양시 일산서구 일산1동,1,주말,00시~01시,5 ,23 ,28 
경기도 고양시 일산서구 일산1동,1,주말,주간,1449 ,1120 ,2569 
경기도 고양시 일산서구 일산1동,1,주말,전일,1726 ,1762 ,3488 
경기도 고양시 일산서구 일산2동,1,평일,01시~02시,-,1 ,1 
경기도 고양시 일산서구 일산2동,1,평일,04시~05시,17 ,1 ,18 
경기도 고양시 일산서구 일산2동,1,평일,05시~06시,84 ,31 ,115 
경기도 고양시 일산서구 일산2동,1,평일,06시~07시,286 ,72 ,358 
경기도 고양시 일산서구 일산2동,1,평일,07시~08시,554 ,224 ,778 
경기도 고양시 일산서구 일산2동,1,평일,08시~09시,657 ,338 ,995 
경기도 고양시 일산서구 일산2동,1,평일,09시~10시,547 ,300 ,847 
경기도 고양시 일산서구 일산2동,1,평일,10시~11시,484 ,323 ,807 
경기도 고양시 일산서구 일산2동,1,평일,11시~12시,439 ,394 ,833 
경기도 고양시 일산서구 일산2동,1,평일,12시~13시,522 ,403 ,925 
경기도 고양시 일산서구 일산2동,1,평일,13시~14시,521 ,367 ,888 
경기도 고양시 일산서구 일산2동,1,평일,14시~15시,486 ,395 ,881 
경기도 고양시 일산서구 일산2동,1,평일,15시~16시,534 ,409 ,943 
경기도 고양시 일산서구 일산2동,1,평일,16시~17시,473 ,406 ,879 
경기도 고양시 일산서구 일산2동,1,평일,17시~18시,502 ,396 ,898 
경기도 고양시 일산서구 일산2동,1,평일,18시~19시,487 ,502 ,989 
경기도 고양시 일산서구 일산2동,1,평일,19시~20시,280 ,355 ,635 
경기도 고양시 일산서구 일산2동,1,평일,20시~21시,171 ,254 ,425 
경기도 고양시 일산서구 일산2동,1,평일,21시~22시,161 ,291 ,452 
경기도 고양시 일산서구 일산2동,1,평일,22시~23시,135 ,249 ,384 
경기도 고양시 일산서구 일산2동,1,평일,23시~24시,73 ,138 ,211 
경기도 고양시 일산서구 일산2동,1,평일,00시~01시,26 ,30 ,56 
경기도 고양시 일산서구 일산2동,1,평일,주간,6206 ,4457 ,10663 
경기도 고양시 일산서구 일산2동,1,평일,전일,7439 ,5879 ,13318 
경기도 고양시 일산서구 일산2동,1,주말,04시~05시,17 ,2 ,19 
경기도 고양시 일산서구 일산2동,1,주말,05시~06시,75 ,33 ,108 
경기도 고양시 일산서구 일산2동,1,주말,06시~07시,119 ,51 ,170 
경기도 고양시 일산서구 일산2동,1,주말,07시~08시,217 ,93 ,310 
경기도 고양시 일산서구 일산2동,1,주말,08시~09시,351 ,165 ,516 
경기도 고양시 일산서구 일산2동,1,주말,09시~10시,424 ,190 ,614 
경기도 고양시 일산서구 일산2동,1,주말,10시~11시,395 ,166 ,561 
경기도 고양시 일산서구 일산2동,1,주말,11시~12시,379 ,245 ,624 
경기도 고양시 일산서구 일산2동,1,주말,12시~13시,393 ,226 ,619 
경기도 고양시 일산서구 일산2동,1,주말,13시~14시,422 ,259 ,681 
경기도 고양시 일산서구 일산2동,1,주말,14시~15시,351 ,219 ,570 
경기도 고양시 일산서구 일산2동,1,주말,15시~16시,318 ,232 ,550 
경기도 고양시 일산서구 일산2동,1,주말,16시~17시,284 ,273 ,557 
경기도 고양시 일산서구 일산2동,1,주말,17시~18시,274 ,291 ,565 
경기도 고양시 일산서구 일산2동,1,주말,18시~19시,287 ,315 ,602 
경기도 고양시 일산서구 일산2동,1,주말,19시~20시,214 ,208 ,422 
경기도 고양시 일산서구 일산2동,1,주말,20시~21시,146 ,163 ,309 
경기도 고양시 일산서구 일산2동,1,주말,21시~22시,151 ,268 ,419 
경기도 고양시 일산서구 일산2동,1,주말,22시~23시,117 ,229 ,346 
경기도 고양시 일산서구 일산2동,1,주말,23시~24시,69 ,98 ,167 
경기도 고양시 일산서구 일산2동,1,주말,00시~01시,27 ,53 ,80 
경기도 고양시 일산서구 일산2동,1,주말,주간,4095 ,2674 ,6769 
경기도 고양시 일산서구 일산2동,1,주말,전일,5030 ,3779 ,8809 
경기도 고양시 일산서구 일산3동,1,평일,01시~02시,5 ,6 ,11 
경기도 고양시 일산서구 일산3동,1,평일,04시~05시,8 ,2 ,10 
경기도 고양시 일산서구 일산3동,1,평일,05시~06시,75 ,29 ,104 
경기도 고양시 일산서구 일산3동,1,평일,06시~07시,272 ,132 ,404 
경기도 고양시 일산서구 일산3동,1,평일,07시~08시,574 ,382 ,956 
경기도 고양시 일산서구 일산3동,1,평일,08시~09시,861 ,471 ,1332 
경기도 고양시 일산서구 일산3동,1,평일,09시~10시,503 ,275 ,778 
경기도 고양시 일산서구 일산3동,1,평일,10시~11시,345 ,235 ,580 
경기도 고양시 일산서구 일산3동,1,평일,11시~12시,334 ,293 ,627 
경기도 고양시 일산서구 일산3동,1,평일,12시~13시,336 ,378 ,714 
경기도 고양시 일산서구 일산3동,1,평일,13시~14시,369 ,360 ,729 
경기도 고양시 일산서구 일산3동,1,평일,14시~15시,351 ,355 ,706 
경기도 고양시 일산서구 일산3동,1,평일,15시~16시,344 ,403 ,747 
경기도 고양시 일산서구 일산3동,1,평일,16시~17시,417 ,437 ,854 
경기도 고양시 일산서구 일산3동,1,평일,17시~18시,448 ,515 ,963 
경기도 고양시 일산서구 일산3동,1,평일,18시~19시,608 ,599 ,1207 
경기도 고양시 일산서구 일산3동,1,평일,19시~20시,512 ,543 ,1055 
경기도 고양시 일산서구 일산3동,1,평일,20시~21시,337 ,357 ,694 
경기도 고양시 일산서구 일산3동,1,평일,21시~22시,424 ,333 ,757 
경기도 고양시 일산서구 일산3동,1,평일,22시~23시,454 ,370 ,824 
경기도 고양시 일산서구 일산3동,1,평일,23시~24시,124 ,193 ,317 
경기도 고양시 일산서구 일산3동,1,평일,00시~01시,48 ,83 ,131 
경기도 고양시 일산서구 일산3동,1,평일,주간,5490 ,4703 ,10193 
경기도 고양시 일산서구 일산3동,1,평일,전일,7749 ,6751 ,14500 
경기도 고양시 일산서구 일산3동,1,주말,01시~02시,-,11 ,11 
경기도 고양시 일산서구 일산3동,1,주말,04시~05시,4 ,-,4 
경기도 고양시 일산서구 일산3동,1,주말,05시~06시,43 ,19 ,62 
경기도 고양시 일산서구 일산3동,1,주말,06시~07시,73 ,58 ,131 
경기도 고양시 일산서구 일산3동,1,주말,07시~08시,156 ,91 ,247 
경기도 고양시 일산서구 일산3동,1,주말,08시~09시,297 ,183 ,480 
경기도 고양시 일산서구 일산3동,1,주말,09시~10시,359 ,251 ,610 
경기도 고양시 일산서구 일산3동,1,주말,10시~11시,323 ,250 ,573 
경기도 고양시 일산서구 일산3동,1,주말,11시~12시,409 ,264 ,673 
경기도 고양시 일산서구 일산3동,1,주말,12시~13시,424 ,318 ,742 
경기도 고양시 일산서구 일산3동,1,주말,13시~14시,485 ,279 ,764 
경기도 고양시 일산서구 일산3동,1,주말,14시~15시,401 ,315 ,716 
경기도 고양시 일산서구 일산3동,1,주말,15시~16시,389 ,298 ,687 
경기도 고양시 일산서구 일산3동,1,주말,16시~17시,444 ,310 ,754 
경기도 고양시 일산서구 일산3동,1,주말,17시~18시,454 ,346 ,800 
경기도 고양시 일산서구 일산3동,1,주말,18시~19시,448 ,383 ,831 
경기도 고양시 일산서구 일산3동,1,주말,19시~20시,369 ,254 ,623 
경기도 고양시 일산서구 일산3동,1,주말,20시~21시,289 ,256 ,545 
경기도 고양시 일산서구 일산3동,1,주말,21시~22시,237 ,230 ,467 
경기도 고양시 일산서구 일산3동,1,주말,22시~23시,251 ,334 ,585 
경기도 고양시 일산서구 일산3동,1,주말,23시~24시,123 ,211 ,334 
경기도 고양시 일산서구 일산3동,1,주말,00시~01시,37 ,67 ,104 
경기도 고양시 일산서구 일산3동,1,주말,주간,4589 ,3288 ,7877 
경기도 고양시 일산서구 일산3동,1,주말,전일,6015 ,4728 ,10743 
경기도 고양시 일산서구 탄현동,1,평일,01시~02시,-,24 ,24 
경기도 고양시 일산서구 탄현동,1,평일,02시~03시,-,2 ,2 
경기도 고양시 일산서구 탄현동,1,평일,04시~05시,5 ,-,5 
경기도 고양시 일산서구 탄현동,1,평일,05시~06시,95 ,4 ,99 
경기도 고양시 일산서구 탄현동,1,평일,06시~07시,351 ,54 ,405 
경기도 고양시 일산서구 탄현동,1,평일,07시~08시,629 ,153 ,782 
경기도 고양시 일산서구 탄현동,1,평일,08시~09시,660 ,296 ,956 
경기도 고양시 일산서구 탄현동,1,평일,09시~10시,488 ,171 ,659 
경기도 고양시 일산서구 탄현동,1,평일,10시~11시,375 ,150 ,525 
경기도 고양시 일산서구 탄현동,1,평일,11시~12시,392 ,201 ,593 
경기도 고양시 일산서구 탄현동,1,평일,12시~13시,350 ,214 ,564 
경기도 고양시 일산서구 탄현동,1,평일,13시~14시,366 ,264 ,630 
경기도 고양시 일산서구 탄현동,1,평일,14시~15시,320 ,304 ,624 
경기도 고양시 일산서구 탄현동,1,평일,15시~16시,343 ,324 ,667 
경기도 고양시 일산서구 탄현동,1,평일,16시~17시,447 ,400 ,847 
경기도 고양시 일산서구 탄현동,1,평일,17시~18시,348 ,367 ,715 
경기도 고양시 일산서구 탄현동,1,평일,18시~19시,259 ,404 ,663 
경기도 고양시 일산서구 탄현동,1,평일,19시~20시,223 ,440 ,663 
경기도 고양시 일산서구 탄현동,1,평일,20시~21시,168 ,393 ,561 
경기도 고양시 일산서구 탄현동,1,평일,21시~22시,132 ,293 ,425 
경기도 고양시 일산서구 탄현동,1,평일,22시~23시,114 ,326 ,440 
경기도 고양시 일산서구 탄현동,1,평일,23시~24시,60 ,244 ,304 
경기도 고양시 일산서구 탄현동,1,평일,00시~01시,10 ,66 ,76 
경기도 고양시 일산서구 탄현동,1,평일,주간,4977 ,3248 ,8225 
경기도 고양시 일산서구 탄현동,1,평일,전일,6135 ,5094 ,11229 
경기도 고양시 일산서구 탄현동,1,주말,01시~02시,1 ,26 ,27 
경기도 고양시 일산서구 탄현동,1,주말,02시~03시,-,8 ,8 
경기도 고양시 일산서구 탄현동,1,주말,04시~05시,5 ,-,5 
경기도 고양시 일산서구 탄현동,1,주말,05시~06시,59 ,8 ,67 
경기도 고양시 일산서구 탄현동,1,주말,06시~07시,100 ,34 ,134 
경기도 고양시 일산서구 탄현동,1,주말,07시~08시,199 ,46 ,245 
경기도 고양시 일산서구 탄현동,1,주말,08시~09시,310 ,99 ,409 
경기도 고양시 일산서구 탄현동,1,주말,09시~10시,355 ,90 ,445 
경기도 고양시 일산서구 탄현동,1,주말,10시~11시,312 ,130 ,442 
경기도 고양시 일산서구 탄현동,1,주말,11시~12시,362 ,122 ,484 
경기도 고양시 일산서구 탄현동,1,주말,12시~13시,326 ,178 ,504 
경기도 고양시 일산서구 탄현동,1,주말,13시~14시,315 ,197 ,512 
경기도 고양시 일산서구 탄현동,1,주말,14시~15시,288 ,217 ,505 
경기도 고양시 일산서구 탄현동,1,주말,15시~16시,229 ,183 ,412 
경기도 고양시 일산서구 탄현동,1,주말,16시~17시,238 ,287 ,525 
경기도 고양시 일산서구 탄현동,1,주말,17시~18시,246 ,240 ,486 
경기도 고양시 일산서구 탄현동,1,주말,18시~19시,217 ,291 ,508 
경기도 고양시 일산서구 탄현동,1,주말,19시~20시,141 ,250 ,391 
경기도 고양시 일산서구 탄현동,1,주말,20시~21시,103 ,198 ,301 
경기도 고양시 일산서구 탄현동,1,주말,21시~22시,112 ,261 ,373 
경기도 고양시 일산서구 탄현동,1,주말,22시~23시,105 ,285 ,390 
경기도 고양시 일산서구 탄현동,1,주말,23시~24시,32 ,219 ,251 
경기도 고양시 일산서구 탄현동,1,주말,00시~01시,5 ,100 ,105 
경기도 고양시 일산서구 탄현동,1,주말,주간,3397 ,2080 ,5477 
경기도 고양시 일산서구 탄현동,1,주말,전일,4060 ,3469 ,7529 
경기도 고양시 일산서구 주엽1동,1,평일,01시~02시,6 ,18 ,24 
경기도 고양시 일산서구 주엽1동,1,평일,02시~03시,-,3 ,3 
경기도 고양시 일산서구 주엽1동,1,평일,04시~05시,13 ,1 ,14 
경기도 고양시 일산서구 주엽1동,1,평일,05시~06시,103 ,65 ,168 
경기도 고양시 일산서구 주엽1동,1,평일,06시~07시,357 ,197 ,554 
경기도 고양시 일산서구 주엽1동,1,평일,07시~08시,646 ,444 ,1090 
경기도 고양시 일산서구 주엽1동,1,평일,08시~09시,813 ,863 ,1676 
경기도 고양시 일산서구 주엽1동,1,평일,09시~10시,568 ,742 ,1310 
경기도 고양시 일산서구 주엽1동,1,평일,10시~11시,444 ,554 ,998 
경기도 고양시 일산서구 주엽1동,1,평일,11시~12시,711 ,566 ,1277 
경기도 고양시 일산서구 주엽1동,1,평일,12시~13시,612 ,498 ,1110 
경기도 고양시 일산서구 주엽1동,1,평일,13시~14시,597 ,605 ,1202 
경기도 고양시 일산서구 주엽1동,1,평일,14시~15시,601 ,543 ,1144 
경기도 고양시 일산서구 주엽1동,1,평일,15시~16시,730 ,708 ,1438 
경기도 고양시 일산서구 주엽1동,1,평일,16시~17시,820 ,639 ,1459 
경기도 고양시 일산서구 주엽1동,1,평일,17시~18시,778 ,751 ,1529 
경기도 고양시 일산서구 주엽1동,1,평일,18시~19시,923 ,914 ,1837 
경기도 고양시 일산서구 주엽1동,1,평일,19시~20시,776 ,822 ,1598 
경기도 고양시 일산서구 주엽1동,1,평일,20시~21시,668 ,652 ,1320 
경기도 고양시 일산서구 주엽1동,1,평일,21시~22시,468 ,557 ,1025 
경기도 고양시 일산서구 주엽1동,1,평일,22시~23시,557 ,522 ,1079 
경기도 고양시 일산서구 주엽1동,1,평일,23시~24시,267 ,357 ,624 
경기도 고양시 일산서구 주엽1동,1,평일,00시~01시,60 ,118 ,178 
경기도 고양시 일산서구 주엽1동,1,평일,주간,8243 ,7827 ,16070 
경기도 고양시 일산서구 주엽1동,1,평일,전일,11518 ,11139 ,22657 
경기도 고양시 일산서구 주엽1동,1,주말,01시~02시,8 ,32 ,40 
경기도 고양시 일산서구 주엽1동,1,주말,02시~03시,2 ,4 ,6 
경기도 고양시 일산서구 주엽1동,1,주말,04시~05시,12 ,3 ,15 
경기도 고양시 일산서구 주엽1동,1,주말,05시~06시,77 ,62 ,139 
경기도 고양시 일산서구 주엽1동,1,주말,06시~07시,143 ,131 ,274 
경기도 고양시 일산서구 주엽1동,1,주말,07시~08시,215 ,209 ,424 
경기도 고양시 일산서구 주엽1동,1,주말,08시~09시,318 ,387 ,705 
경기도 고양시 일산서구 주엽1동,1,주말,09시~10시,462 ,547 ,1009 
경기도 고양시 일산서구 주엽1동,1,주말,10시~11시,394 ,476 ,870 
경기도 고양시 일산서구 주엽1동,1,주말,11시~12시,525 ,502 ,1027 
경기도 고양시 일산서구 주엽1동,1,주말,12시~13시,628 ,501 ,1129 
경기도 고양시 일산서구 주엽1동,1,주말,13시~14시,637 ,554 ,1191 
경기도 고양시 일산서구 주엽1동,1,주말,14시~15시,563 ,490 ,1053 
경기도 고양시 일산서구 주엽1동,1,주말,15시~16시,650 ,522 ,1172 
경기도 고양시 일산서구 주엽1동,1,주말,16시~17시,685 ,543 ,1228 
경기도 고양시 일산서구 주엽1동,1,주말,17시~18시,716 ,567 ,1283 
경기도 고양시 일산서구 주엽1동,1,주말,18시~19시,654 ,633 ,1287 
경기도 고양시 일산서구 주엽1동,1,주말,19시~20시,495 ,493 ,988 
경기도 고양시 일산서구 주엽1동,1,주말,20시~21시,433 ,406 ,839 
경기도 고양시 일산서구 주엽1동,1,주말,21시~22시,400 ,377 ,777 
경기도 고양시 일산서구 주엽1동,1,주말,22시~23시,396 ,440 ,836 
경기도 고양시 일산서구 주엽1동,1,주말,23시~24시,219 ,293 ,512 
경기도 고양시 일산서구 주엽1동,1,주말,00시~01시,66 ,154 ,220 
경기도 고양시 일산서구 주엽1동,1,주말,주간,6447 ,5931 ,12378 
경기도 고양시 일산서구 주엽1동,1,주말,전일,8698 ,8326 ,17024 
경기도 고양시 일산서구 주엽2동,1,평일,01시~02시,-,10 ,10 
경기도 고양시 일산서구 주엽2동,1,평일,02시~03시,1 ,2 ,3 
경기도 고양시 일산서구 주엽2동,1,평일,04시~05시,28 ,9 ,37 
경기도 고양시 일산서구 주엽2동,1,평일,05시~06시,120 ,82 ,202 
경기도 고양시 일산서구 주엽2동,1,평일,06시~07시,423 ,214 ,637 
경기도 고양시 일산서구 주엽2동,1,평일,07시~08시,777 ,410 ,1187 
경기도 고양시 일산서구 주엽2동,1,평일,08시~09시,759 ,699 ,1458 
경기도 고양시 일산서구 주엽2동,1,평일,09시~10시,519 ,722 ,1241 
경기도 고양시 일산서구 주엽2동,1,평일,10시~11시,417 ,495 ,912 
경기도 고양시 일산서구 주엽2동,1,평일,11시~12시,471 ,529 ,1000 
경기도 고양시 일산서구 주엽2동,1,평일,12시~13시,524 ,522 ,1046 
경기도 고양시 일산서구 주엽2동,1,평일,13시~14시,515 ,645 ,1160 
경기도 고양시 일산서구 주엽2동,1,평일,14시~15시,437 ,598 ,1035 
경기도 고양시 일산서구 주엽2동,1,평일,15시~16시,485 ,529 ,1014 
경기도 고양시 일산서구 주엽2동,1,평일,16시~17시,595 ,581 ,1176 
경기도 고양시 일산서구 주엽2동,1,평일,17시~18시,663 ,674 ,1337 
경기도 고양시 일산서구 주엽2동,1,평일,18시~19시,677 ,840 ,1517 
경기도 고양시 일산서구 주엽2동,1,평일,19시~20시,466 ,633 ,1099 
경기도 고양시 일산서구 주엽2동,1,평일,20시~21시,405 ,516 ,921 
경기도 고양시 일산서구 주엽2동,1,평일,21시~22시,302 ,379 ,681 
경기도 고양시 일산서구 주엽2동,1,평일,22시~23시,396 ,414 ,810 
경기도 고양시 일산서구 주엽2동,1,평일,23시~24시,136 ,239 ,375 
경기도 고양시 일산서구 주엽2동,1,평일,00시~01시,14 ,76 ,90 
경기도 고양시 일산서구 주엽2동,1,평일,주간,6839 ,7244 ,14083 
경기도 고양시 일산서구 주엽2동,1,평일,전일,9130 ,9818 ,18948 
경기도 고양시 일산서구 주엽2동,1,주말,01시~02시,4 ,25 ,29 
경기도 고양시 일산서구 주엽2동,1,주말,02시~03시,-,4 ,4 
경기도 고양시 일산서구 주엽2동,1,주말,04시~05시,18 ,2 ,20 
경기도 고양시 일산서구 주엽2동,1,주말,05시~06시,75 ,64 ,139 
경기도 고양시 일산서구 주엽2동,1,주말,06시~07시,139 ,107 ,246 
경기도 고양시 일산서구 주엽2동,1,주말,07시~08시,182 ,193 ,375 
경기도 고양시 일산서구 주엽2동,1,주말,08시~09시,306 ,422 ,728 
경기도 고양시 일산서구 주엽2동,1,주말,09시~10시,393 ,571 ,964 
경기도 고양시 일산서구 주엽2동,1,주말,10시~11시,435 ,508 ,943 
경기도 고양시 일산서구 주엽2동,1,주말,11시~12시,528 ,544 ,1072 
경기도 고양시 일산서구 주엽2동,1,주말,12시~13시,600 ,567 ,1167 
경기도 고양시 일산서구 주엽2동,1,주말,13시~14시,594 ,606 ,1200 
경기도 고양시 일산서구 주엽2동,1,주말,14시~15시,541 ,507 ,1048 
경기도 고양시 일산서구 주엽2동,1,주말,15시~16시,549 ,457 ,1006 
경기도 고양시 일산서구 주엽2동,1,주말,16시~17시,572 ,477 ,1049 
경기도 고양시 일산서구 주엽2동,1,주말,17시~18시,570 ,486 ,1056 
경기도 고양시 일산서구 주엽2동,1,주말,18시~19시,563 ,522 ,1085 
경기도 고양시 일산서구 주엽2동,1,주말,19시~20시,357 ,389 ,746 
경기도 고양시 일산서구 주엽2동,1,주말,20시~21시,338 ,378 ,716 
경기도 고양시 일산서구 주엽2동,1,주말,21시~22시,278 ,312 ,590 
경기도 고양시 일산서구 주엽2동,1,주말,22시~23시,311 ,326 ,637 
경기도 고양시 일산서구 주엽2동,1,주말,23시~24시,110 ,222 ,332 
경기도 고양시 일산서구 주엽2동,1,주말,00시~01시,32 ,102 ,134 
경기도 고양시 일산서구 주엽2동,1,주말,주간,5833 ,5860 ,11693 
경기도 고양시 일산서구 주엽2동,1,주말,전일,7495 ,7791 ,15286 
경기도 고양시 일산서구 대화동,1,평일,01시~02시,23 ,29 ,52 
경기도 고양시 일산서구 대화동,1,평일,02시~03시,2 ,14 ,16 
경기도 고양시 일산서구 대화동,1,평일,04시~05시,10 ,3 ,13 
경기도 고양시 일산서구 대화동,1,평일,05시~06시,188 ,326 ,514 
경기도 고양시 일산서구 대화동,1,평일,06시~07시,757 ,1185 ,1942 
경기도 고양시 일산서구 대화동,1,평일,07시~08시,1674 ,2661 ,4335 
경기도 고양시 일산서구 대화동,1,평일,08시~09시,1943 ,2564 ,4507 
경기도 고양시 일산서구 대화동,1,평일,09시~10시,1418 ,1940 ,3358 
경기도 고양시 일산서구 대화동,1,평일,10시~11시,1120 ,1386 ,2506 
경기도 고양시 일산서구 대화동,1,평일,11시~12시,1093 ,1450 ,2543 
경기도 고양시 일산서구 대화동,1,평일,12시~13시,1355 ,1291 ,2646 
경기도 고양시 일산서구 대화동,1,평일,13시~14시,1342 ,1342 ,2684 
경기도 고양시 일산서구 대화동,1,평일,14시~15시,1311 ,1254 ,2565 
경기도 고양시 일산서구 대화동,1,평일,15시~16시,1444 ,1399 ,2843 
경기도 고양시 일산서구 대화동,1,평일,16시~17시,1590 ,1377 ,2967 
경기도 고양시 일산서구 대화동,1,평일,17시~18시,1836 ,1578 ,3414 
경기도 고양시 일산서구 대화동,1,평일,18시~19시,2189 ,1897 ,4086 
경기도 고양시 일산서구 대화동,1,평일,19시~20시,1906 ,1494 ,3400 
경기도 고양시 일산서구 대화동,1,평일,20시~21시,1575 ,1210 ,2785 
경기도 고양시 일산서구 대화동,1,평일,21시~22시,1281 ,1080 ,2361 
경기도 고양시 일산서구 대화동,1,평일,22시~23시,1387 ,984 ,2371 
경기도 고양시 일산서구 대화동,1,평일,23시~24시,770 ,568 ,1338 
경기도 고양시 일산서구 대화동,1,평일,00시~01시,227 ,191 ,418 
경기도 고양시 일산서구 대화동,1,평일,주간,18315 ,20139 ,38454 
경기도 고양시 일산서구 대화동,1,평일,전일,26441 ,27223 ,53664 
경기도 고양시 일산서구 대화동,1,주말,01시~02시,26 ,62 ,88 
경기도 고양시 일산서구 대화동,1,주말,02시~03시,1 ,11 ,12 
경기도 고양시 일산서구 대화동,1,주말,04시~05시,14 ,2 ,16 
경기도 고양시 일산서구 대화동,1,주말,05시~06시,129 ,176 ,305 
경기도 고양시 일산서구 대화동,1,주말,06시~07시,371 ,448 ,819 
경기도 고양시 일산서구 대화동,1,주말,07시~08시,586 ,729 ,1315 
경기도 고양시 일산서구 대화동,1,주말,08시~09시,874 ,1074 ,1948 
경기도 고양시 일산서구 대화동,1,주말,09시~10시,1182 ,1549 ,2731 
경기도 고양시 일산서구 대화동,1,주말,10시~11시,1011 ,1314 ,2325 
경기도 고양시 일산서구 대화동,1,주말,11시~12시,1159 ,1513 ,2672 
경기도 고양시 일산서구 대화동,1,주말,12시~13시,1193 ,1359 ,2552 
경기도 고양시 일산서구 대화동,1,주말,13시~14시,1143 ,1362 ,2505 
경기도 고양시 일산서구 대화동,1,주말,14시~15시,1198 ,1302 ,2500 
경기도 고양시 일산서구 대화동,1,주말,15시~16시,1298 ,1324 ,2622 
경기도 고양시 일산서구 대화동,1,주말,16시~17시,1321 ,1365 ,2686 
경기도 고양시 일산서구 대화동,1,주말,17시~18시,1429 ,1445 ,2874 
경기도 고양시 일산서구 대화동,1,주말,18시~19시,1540 ,1505 ,3045 
경기도 고양시 일산서구 대화동,1,주말,19시~20시,1314 ,1031 ,2345 
경기도 고양시 일산서구 대화동,1,주말,20시~21시,1146 ,1046 ,2192 
경기도 고양시 일산서구 대화동,1,주말,21시~22시,1226 ,939 ,2165 
경기도 고양시 일산서구 대화동,1,주말,22시~23시,1077 ,877 ,1954 
경기도 고양시 일산서구 대화동,1,주말,23시~24시,767 ,547 ,1314 
경기도 고양시 일산서구 대화동,1,주말,00시~01시,157 ,232 ,389 
경기도 고양시 일산서구 대화동,1,주말,주간,13934 ,15841 ,29775 
경기도 고양시 일산서구 대화동,1,주말,전일,20162 ,21212 ,41374 
경기도 고양시 일산서구 송포동,1,평일,01시~02시,-,26 ,26 
경기도 고양시 일산서구 송포동,1,평일,02시~03시,-,8 ,8 
경기도 고양시 일산서구 송포동,1,평일,04시~05시,12 ,-,12 
경기도 고양시 일산서구 송포동,1,평일,05시~06시,82 ,30 ,112 
경기도 고양시 일산서구 송포동,1,평일,06시~07시,297 ,255 ,552 
경기도 고양시 일산서구 송포동,1,평일,07시~08시,562 ,383 ,945 
경기도 고양시 일산서구 송포동,1,평일,08시~09시,487 ,705 ,1192 
경기도 고양시 일산서구 송포동,1,평일,09시~10시,422 ,812 ,1234 
경기도 고양시 일산서구 송포동,1,평일,10시~11시,381 ,472 ,853 
경기도 고양시 일산서구 송포동,1,평일,11시~12시,329 ,418 ,747 
경기도 고양시 일산서구 송포동,1,평일,12시~13시,372 ,424 ,796 
경기도 고양시 일산서구 송포동,1,평일,13시~14시,370 ,437 ,807 
경기도 고양시 일산서구 송포동,1,평일,14시~15시,395 ,381 ,776 
경기도 고양시 일산서구 송포동,1,평일,15시~16시,463 ,432 ,895 
경기도 고양시 일산서구 송포동,1,평일,16시~17시,508 ,419 ,927 
경기도 고양시 일산서구 송포동,1,평일,17시~18시,541 ,432 ,973 
경기도 고양시 일산서구 송포동,1,평일,18시~19시,648 ,508 ,1156 
경기도 고양시 일산서구 송포동,1,평일,19시~20시,391 ,572 ,963 
경기도 고양시 일산서구 송포동,1,평일,20시~21시,399 ,421 ,820 
경기도 고양시 일산서구 송포동,1,평일,21시~22시,227 ,311 ,538 
경기도 고양시 일산서구 송포동,1,평일,22시~23시,144 ,314 ,458 
경기도 고양시 일산서구 송포동,1,평일,23시~24시,61 ,214 ,275 
경기도 고양시 일산서구 송포동,1,평일,00시~01시,17 ,80 ,97 
경기도 고양시 일산서구 송포동,1,평일,주간,5478 ,5823 ,11301 
경기도 고양시 일산서구 송포동,1,평일,전일,7108 ,8054 ,15162 
경기도 고양시 일산서구 송포동,1,주말,01시~02시,-,25 ,25 
경기도 고양시 일산서구 송포동,1,주말,02시~03시,1 ,3 ,4 
경기도 고양시 일산서구 송포동,1,주말,04시~05시,7 ,1 ,8 
경기도 고양시 일산서구 송포동,1,주말,05시~06시,48 ,41 ,89 
경기도 고양시 일산서구 송포동,1,주말,06시~07시,83 ,194 ,277 
경기도 고양시 일산서구 송포동,1,주말,07시~08시,159 ,218 ,377 
경기도 고양시 일산서구 송포동,1,주말,08시~09시,229 ,298 ,527 
경기도 고양시 일산서구 송포동,1,주말,09시~10시,305 ,590 ,895 
경기도 고양시 일산서구 송포동,1,주말,10시~11시,332 ,466 ,798 
경기도 고양시 일산서구 송포동,1,주말,11시~12시,359 ,520 ,879 
경기도 고양시 일산서구 송포동,1,주말,12시~13시,327 ,451 ,778 
경기도 고양시 일산서구 송포동,1,주말,13시~14시,338 ,450 ,788 
경기도 고양시 일산서구 송포동,1,주말,14시~15시,381 ,447 ,828 
경기도 고양시 일산서구 송포동,1,주말,15시~16시,489 ,405 ,894 
경기도 고양시 일산서구 송포동,1,주말,16시~17시,507 ,393 ,900 
경기도 고양시 일산서구 송포동,1,주말,17시~18시,599 ,370 ,969 
경기도 고양시 일산서구 송포동,1,주말,18시~19시,673 ,429 ,1102 
경기도 고양시 일산서구 송포동,1,주말,19시~20시,411 ,290 ,701 
경기도 고양시 일산서구 송포동,1,주말,20시~21시,492 ,258 ,750 
경기도 고양시 일산서구 송포동,1,주말,21시~22시,356 ,263 ,619 
경기도 고양시 일산서구 송포동,1,주말,22시~23시,171 ,248 ,419 
경기도 고양시 일산서구 송포동,1,주말,23시~24시,98 ,215 ,313 
경기도 고양시 일산서구 송포동,1,주말,00시~01시,13 ,97 ,110 
경기도 고양시 일산서구 송포동,1,주말,주간,4698 ,5037 ,9735 
경기도 고양시 일산서구 송포동,1,주말,전일,6378 ,6672 ,13050 
경기도 고양시 일산서구 송산동,1,평일,01시~02시,-,28 ,28 
경기도 고양시 일산서구 송산동,1,평일,02시~03시,-,1 ,1 
경기도 고양시 일산서구 송산동,1,평일,04시~05시,9 ,-,9 
경기도 고양시 일산서구 송산동,1,평일,05시~06시,169 ,38 ,207 
경기도 고양시 일산서구 송산동,1,평일,06시~07시,564 ,151 ,715 
경기도 고양시 일산서구 송산동,1,평일,07시~08시,999 ,420 ,1419 
경기도 고양시 일산서구 송산동,1,평일,08시~09시,1024 ,727 ,1751 
경기도 고양시 일산서구 송산동,1,평일,09시~10시,814 ,436 ,1250 
경기도 고양시 일산서구 송산동,1,평일,10시~11시,606 ,395 ,1001 
경기도 고양시 일산서구 송산동,1,평일,11시~12시,566 ,312 ,878 
경기도 고양시 일산서구 송산동,1,평일,12시~13시,579 ,436 ,1015 
경기도 고양시 일산서구 송산동,1,평일,13시~14시,686 ,462 ,1148 
경기도 고양시 일산서구 송산동,1,평일,14시~15시,539 ,458 ,997 
경기도 고양시 일산서구 송산동,1,평일,15시~16시,564 ,510 ,1074 
경기도 고양시 일산서구 송산동,1,평일,16시~17시,604 ,611 ,1215 
경기도 고양시 일산서구 송산동,1,평일,17시~18시,679 ,677 ,1356 
경기도 고양시 일산서구 송산동,1,평일,18시~19시,757 ,866 ,1623 
경기도 고양시 일산서구 송산동,1,평일,19시~20시,460 ,868 ,1328 
경기도 고양시 일산서구 송산동,1,평일,20시~21시,266 ,664 ,930 
경기도 고양시 일산서구 송산동,1,평일,21시~22시,258 ,614 ,872 
경기도 고양시 일산서구 송산동,1,평일,22시~23시,235 ,607 ,842 
경기도 고양시 일산서구 송산동,1,평일,23시~24시,125 ,414 ,539 
경기도 고양시 일산서구 송산동,1,평일,00시~01시,36 ,150 ,186 
경기도 고양시 일산서구 송산동,1,평일,주간,8417 ,6310 ,14727 
경기도 고양시 일산서구 송산동,1,평일,전일,10539 ,9845 ,20384 
경기도 고양시 일산서구 송산동,1,주말,01시~02시,1 ,24 ,25 
경기도 고양시 일산서구 송산동,1,주말,02시~03시,-,2 ,2 
경기도 고양시 일산서구 송산동,1,주말,04시~05시,3 ,-,3 
경기도 고양시 일산서구 송산동,1,주말,05시~06시,98 ,28 ,126 
경기도 고양시 일산서구 송산동,1,주말,06시~07시,163 ,112 ,275 
경기도 고양시 일산서구 송산동,1,주말,07시~08시,318 ,214 ,532 
경기도 고양시 일산서구 송산동,1,주말,08시~09시,454 ,292 ,746 
경기도 고양시 일산서구 송산동,1,주말,09시~10시,587 ,337 ,924 
경기도 고양시 일산서구 송산동,1,주말,10시~11시,622 ,302 ,924 
경기도 고양시 일산서구 송산동,1,주말,11시~12시,603 ,317 ,920 
경기도 고양시 일산서구 송산동,1,주말,12시~13시,623 ,375 ,998 
경기도 고양시 일산서구 송산동,1,주말,13시~14시,648 ,357 ,1005 
경기도 고양시 일산서구 송산동,1,주말,14시~15시,601 ,407 ,1008 
경기도 고양시 일산서구 송산동,1,주말,15시~16시,512 ,407 ,919 
경기도 고양시 일산서구 송산동,1,주말,16시~17시,560 ,506 ,1066 
경기도 고양시 일산서구 송산동,1,주말,17시~18시,549 ,575 ,1124 
경기도 고양시 일산서구 송산동,1,주말,18시~19시,442 ,615 ,1057 
경기도 고양시 일산서구 송산동,1,주말,19시~20시,300 ,500 ,800 
경기도 고양시 일산서구 송산동,1,주말,20시~21시,279 ,454 ,733 
경기도 고양시 일산서구 송산동,1,주말,21시~22시,293 ,482 ,775 
경기도 고양시 일산서구 송산동,1,주말,22시~23시,202 ,490 ,692 
경기도 고양시 일산서구 송산동,1,주말,23시~24시,99 ,353 ,452 
경기도 고양시 일산서구 송산동,1,주말,00시~01시,26 ,139 ,165 
경기도 고양시 일산서구 송산동,1,주말,주간,6519 ,4704 ,11223 
경기도 고양시 일산서구 송산동,1,주말,전일,7983 ,7288 ,15271 
